,primary_title,release_date,release_year,runtime_minutes,genres,averagerating,numvotes,production_budget,domestic_gross,worldwide_gross,domestic_profit,worldwide_profit
1,The Overnight,"Jun 19, 2015",2015,79.0,"Comedy,Mystery",6.1,14828,200000,1109808,1165996,909808,965996
2,The Secret Life of Walter Mitty,"Dec 25, 2013",2013,114.0,"Adventure,Comedy,Drama",7.3,275300,91000000,58236838,187861183,-32763162,96861183
3,A Walk Among the Tombstones,"Sep 19, 2014",2014,114.0,"Action,Crime,Drama",6.5,105116,28000000,26017685,62108587,-1982315,34108587
4,Jurassic World,"Jun 12, 2015",2015,124.0,"Action,Adventure,Sci-Fi",7.0,539338,215000000,652270625,1648854864,437270625,1433854864
5,The Three Stooges,"Apr 13, 2012",2012,92.0,"Comedy,Family",5.1,28570,30000000,44338224,54052249,14338224,24052249
6,Tangled,"Nov 24, 2010",2010,100.0,"Adventure,Animation,Comedy",7.8,366366,260000000,200821936,586477240,-59178064,326477240
7,John Carter,"Mar 9, 2012",2012,132.0,"Action,Adventure,Sci-Fi",6.6,241792,275000000,73058679,282778100,-201941321,7778100
9,Dinner for Schmucks,"Jul 30, 2010",2010,114.0,Comedy,5.9,91546,69000000,73026337,86796502,4026337,17796502
10,The A-Team,"Jun 11, 2010",2010,117.0,"Action,Adventure,Thriller",6.8,235256,110000000,77222099,177241171,-32777901,67241171
11,The Possession,"Aug 31, 2012",2012,92.0,"Horror,Mystery,Thriller",5.9,53649,14000000,49130588,82925064,35130588,68925064
12,Real Steel,"Oct 7, 2011",2011,127.0,"Action,Drama,Family",7.1,283534,110000000,85463309,263880341,-24536691,153880341
13,The Giver,"Aug 15, 2014",2014,97.0,"Drama,Romance,Sci-Fi",6.5,104999,25000000,45090374,66540205,20090374,41540205
14,Toy Story 3,"Jun 18, 2010",2010,103.0,"Adventure,Animation,Comedy",8.3,682218,200000000,415004880,1068879522,215004880,868879522
16,The Devil Inside,"Jan 6, 2012",2012,83.0,Horror,4.2,33522,1000000,53262945,101759490,52262945,100759490
17,Alita: Battle Angel,"Feb 14, 2019",2019,122.0,"Action,Adventure,Sci-Fi",7.5,88207,170000000,85710210,402976036,-84289790,232976036
18,Lincoln,"Nov 9, 2012",2012,150.0,"Biography,Drama,History",7.4,228701,65000000,182207973,273346281,117207973,208346281
19,Shazam!,"Apr 5, 2019",2019,132.0,"Action,Adventure,Comedy",7.4,109051,85000000,139606856,362899733,54606856,277899733
20,Puss in Boots,"Oct 28, 2011",2011,90.0,"Action,Adventure,Animation",6.6,133355,130000000,149260504,554987477,19260504,424987477
21,Wonder Woman,"Jun 2, 2017",2017,141.0,"Action,Adventure,Fantasy",7.5,487527,150000000,412563408,821133378,262563408,671133378
24,42,"Apr 12, 2013",2013,128.0,"Biography,Drama,Sport",7.5,77703,31000000,95020213,97470701,64020213,66470701
25,Life of Pi,"Nov 21, 2012",2012,127.0,"Adventure,Drama,Fantasy",7.9,535836,120000000,124987022,620912003,4987022,500912003
26,The Crazies,"Feb 26, 2010",2010,101.0,"Horror,Thriller",6.5,104465,19000000,39123589,56445534,20123589,37445534
27,The Equalizer,"Sep 26, 2014",2014,132.0,"Action,Crime,Thriller",7.2,302302,55000000,101530738,192903624,46530738,137903624
28,Captain America: The First Avenger,"Jul 22, 2011",2011,124.0,"Action,Adventure,Sci-Fi",6.9,668137,140000000,176654505,370569776,36654505,230569776
29,Piranha 3D,"Aug 20, 2010",2010,88.0,"Comedy,Horror",5.4,81327,24000000,25003155,83660160,1003155,59660160
31,Tower Heist,"Nov 4, 2011",2011,104.0,"Action,Comedy,Crime",6.2,125102,85000000,78046570,150422946,-6953430,65422946
32,The Smurfs,"Jul 29, 2011",2011,103.0,"Adventure,Animation,Comedy",5.5,77577,110000000,142614158,563749323,32614158,453749323
33,The Mechanic,"Jan 28, 2011",2011,93.0,"Action,Crime,Thriller",6.6,141254,42500000,29121498,76347393,-13378502,33847393
34,"Hail, Caesar!","Feb 5, 2016",2016,106.0,"Comedy,Drama,Music",6.3,111422,22000000,30080225,64160680,8080225,42160680
35,Unstoppable,"Nov 12, 2010",2010,98.0,"Action,Thriller",6.8,173019,95000000,81562942,165720921,-13437058,70720921
38,The Tree of Life,"May 27, 2011",2011,139.0,"Drama,Fantasy",6.8,156266,35000000,13305665,61721826,-21694335,26721826
39,Ant-Man,"Jul 17, 2015",2015,117.0,"Action,Adventure,Comedy",7.3,501213,130000000,180202163,518858449,50202163,388858449
40,Season of the Witch,"Jan 7, 2011",2011,95.0,"Action,Adventure,Fantasy",5.4,85777,40000000,24827228,91126600,-15172772,51126600
41,The Losers,"Apr 23, 2010",2010,97.0,"Action,Adventure,Crime",6.4,83876,25000000,23591432,29863840,-1408568,4863840
43,Hall Pass,"Feb 25, 2011",2011,105.0,"Comedy,Romance",5.9,113775,68000000,45060734,87173475,-22939266,19173475
44,The Croods,"Mar 22, 2013",2013,98.0,"Action,Adventure,Animation",7.2,176699,135000000,187168425,573068425,52168425,438068425
45,Something Borrowed,"May 6, 2011",2011,112.0,"Comedy,Drama,Romance",5.9,54314,35000000,39046489,65084116,4046489,30084116
46,Furry Vengeance,"Apr 30, 2010",2010,92.0,"Comedy,Family",3.8,14700,35000000,17630465,39340177,-17369535,4340177
47,Ramona and Beezus,"Jul 23, 2010",2010,103.0,"Adventure,Comedy,Family",6.6,16086,15000000,26167002,27469621,11167002,12469621
48,Rings,"Feb 3, 2017",2017,102.0,"Drama,Horror,Mystery",4.5,34151,25000000,27793018,82917283,2793018,57917283
49,What's Your Number?,"Sep 30, 2011",2011,106.0,"Comedy,Romance",6.1,67922,20000000,14011084,30163785,-5988916,10163785
51,Man of Steel,"Jun 14, 2013",2013,143.0,"Action,Adventure,Sci-Fi",7.1,647288,225000000,291045518,667999518,66045518,442999518
52,Drive,"Sep 16, 2011",2011,100.0,"Crime,Drama",7.8,521495,15000000,35060689,81357930,20060689,66357930
54,The Boxtrolls,"Sep 26, 2014",2014,96.0,"Adventure,Animation,Comedy",6.8,50763,60000000,50837305,111946251,-9162695,51946251
56,Dallas Buyers Club,"Nov 1, 2013",2013,117.0,"Biography,Drama",8.0,402462,5000000,27298285,60611845,22298285,55611845
57,Jack Reacher,"Dec 21, 2012",2012,130.0,"Action,Crime,Thriller",7.0,284547,60000000,80070736,217370736,20070736,157370736
58,Clash of the Titans,"Apr 1, 2010",2010,106.0,"Action,Adventure,Fantasy",5.8,256176,125000000,163214888,493214888,38214888,368214888
61,Thor,"May 6, 2011",2011,115.0,"Action,Adventure,Fantasy",7.0,683264,150000000,181030624,449326618,31030624,299326618
62,Red Dog,"Dec 31, 2011",2011,92.0,"Biography,Comedy,Drama",7.4,15357,9100000,0,20927794,-9100000,11827794
63,Warcraft,"Jun 10, 2016",2016,123.0,"Action,Adventure,Fantasy",6.9,225557,160000000,47225655,425522281,-112774345,265522281
64,Tooth Fairy,"Jan 22, 2010",2010,101.0,"Comedy,Family,Fantasy",5.0,37939,48000000,60022256,112610386,12022256,64610386
65,Jack and Jill,"Nov 11, 2011",2011,91.0,Comedy,3.3,71361,79000000,74158157,150519217,-4841843,71519217
66,Percy Jackson & the Olympians: The Lightning Thief,"Feb 12, 2010",2010,118.0,"Adventure,Family,Fantasy",5.9,165108,95000000,88768303,223050874,-6231697,128050874
67,She's Out of My League,"Mar 12, 2010",2010,104.0,"Comedy,Romance",6.4,117245,20000000,32010860,48680977,12010860,28680977
68,The Book Thief,"Nov 8, 2013",2013,131.0,"Drama,War",7.6,119023,19000000,21488481,76086711,2488481,57086711
70,Interstellar,"Nov 5, 2014",2014,169.0,"Adventure,Drama,Sci-Fi",8.6,1299334,165000000,188017894,666379375,23017894,501379375
71,World War Z,"Jun 21, 2013",2013,116.0,"Action,Adventure,Horror",7.0,553751,190000000,202359711,531514650,12359711,341514650
72,Valentine's Day,"Feb 12, 2010",2010,125.0,"Comedy,Romance",5.7,107171,52000000,110485654,217569328,58485654,165569328
73,Priest,"May 13, 2011",2011,87.0,"Action,Adventure,Fantasy",5.7,108320,60000000,29136626,84154026,-30863374,24154026
74,Dracula Untold,"Oct 10, 2014",2014,92.0,"Action,Drama,Fantasy",6.3,164829,70000000,55991880,220241723,-14008120,150241723
75,Godzilla,"May 16, 2014",2014,123.0,"Action,Adventure,Sci-Fi",6.4,350687,160000000,200676069,529076069,40676069,369076069
77,Hotel Transylvania,"Sep 28, 2012",2012,91.0,"Animation,Comedy,Family",7.1,204571,85000000,148313048,378505812,63313048,293505812
78,Pet Sematary,"Apr 5, 2019",2019,101.0,"Horror,Mystery,Thriller",6.0,34472,21000000,54724696,109501146,33724696,88501146
80,The Town,"Sep 17, 2010",2010,125.0,"Crime,Drama,Thriller",7.6,322524,37000000,92186262,152566881,55186262,115566881
81,The Kids Are All Right,"Jul 9, 2010",2010,106.0,"Comedy,Drama,Romance",7.0,120656,4000000,20811365,36275469,16811365,32275469
82,The Avengers,"May 4, 2012",2012,143.0,"Action,Adventure,Sci-Fi",8.1,1183655,225000000,623279547,1517935897,398279547,1292935897
83,Epic,"May 24, 2013",2013,102.0,"Adventure,Animation,Family",6.7,95318,100000000,107518682,262794441,7518682,162794441
85,Risen,"Feb 19, 2016",2016,107.0,"Action,Adventure,Drama",6.3,22813,20000000,36880033,46255763,16880033,26255763
87,Mr. Peabody & Sherman,"Mar 7, 2014",2014,92.0,"Adventure,Animation,Comedy",6.8,57277,145000000,111506430,269806430,-33493570,124806430
88,Please Give,"Apr 30, 2010",2010,87.0,"Comedy,Drama",6.6,10652,3000000,4033574,4570178,1033574,1570178
89,Eat Pray Love,"Aug 13, 2010",2010,133.0,"Drama,Romance",5.8,77709,60000000,80574010,206598789,20574010,146598789
90,Sanctum,"Feb 4, 2011",2011,108.0,"Adventure,Drama,Thriller",5.9,51318,30000000,23209310,108957098,-6790690,78957098
91,Snitch,"Feb 22, 2013",2013,112.0,"Action,Drama,Thriller",6.5,78142,15000000,42930462,57907734,27930462,42907734
92,The Wedding Ringer,"Jan 16, 2015",2015,101.0,Comedy,6.7,66893,23000000,64460211,80171596,41460211,57171596
93,The Switch,"Aug 20, 2010",2010,101.0,"Comedy,Drama,Romance",6.1,90661,19000000,27758465,49858465,8758465,30858465
94,Letters to Juliet,"May 14, 2010",2010,105.0,"Adventure,Comedy,Drama",6.6,86137,30000000,53032453,82148538,23032453,52148538
95,How to Train Your Dragon,"Mar 26, 2010",2010,98.0,"Action,Adventure,Animation",8.1,611299,165000000,217581232,494870992,52581232,329870992
96,Shrek Forever After,"May 21, 2010",2010,93.0,"Adventure,Animation,Comedy",6.3,167532,165000000,238736787,756244673,73736787,591244673
97,The Hobbit: An Unexpected Journey,"Dec 14, 2012",2012,169.0,"Adventure,Family,Fantasy",7.9,719629,250000000,303003568,1017003568,53003568,767003568
98,The Legend of Tarzan,"Jul 1, 2016",2016,110.0,"Action,Adventure,Drama",6.3,150154,180000000,126643061,348902025,-53356939,168902025
99,Rabbit Hole,"Dec 17, 2010",2010,91.0,Drama,7.0,45357,5000000,2229058,6205034,-2770942,1205034
100,The Last Airbender,"Jul 1, 2010",2010,103.0,"Action,Adventure,Family",4.1,137734,150000000,131772187,319713881,-18227813,169713881
101,Salt,"Jul 23, 2010",2010,100.0,"Action,Mystery,Thriller",6.4,277204,130000000,118311368,290650494,-11688632,160650494
102,Source Code,"Apr 1, 2011",2011,93.0,"Action,Drama,Sci-Fi",7.5,452036,32000000,54712227,140428499,22712227,108428499
103,Black Swan,"Dec 3, 2010",2010,108.0,"Drama,Thriller",8.0,648854,13000000,106954678,331266710,93954678,318266710
104,The Amazing Spider-Man,"Jul 3, 2012",2012,136.0,"Action,Adventure,Sci-Fi",7.0,525632,220000000,262030663,757890267,42030663,537890267
105,Robin Hood,"May 14, 2010",2010,140.0,"Action,Adventure,Drama",6.6,239480,210000000,105487148,322459006,-104512852,112459006
109,The Sorcerer's Apprentice,"Jul 14, 2010",2010,109.0,"Action,Adventure,Family",6.1,143862,160000000,63150991,217986320,-96849009,57986320
110,The Fighter,"Dec 10, 2010",2010,116.0,"Biography,Drama,Sport",7.8,316539,11000000,93617009,129262388,82617009,118262388
111,Hugo,"Nov 23, 2011",2011,126.0,"Adventure,Drama,Family",7.5,284869,180000000,73864507,180047784,-106135493,47784
113,Little Fockers,"Dec 22, 2010",2010,98.0,"Comedy,Romance",5.5,99222,100000000,148438600,310650574,48438600,210650574
114,Justice League,"Nov 17, 2017",2017,120.0,"Action,Adventure,Fantasy",6.5,329135,300000000,229024295,655945209,-70975705,355945209
115,Sucker Punch,"Mar 25, 2011",2011,110.0,"Action,Adventure,Fantasy",6.1,218371,75000000,36392502,89758389,-38607498,14758389
116,Lottery Ticket,"Aug 20, 2010",2010,99.0,Comedy,5.0,10042,17000000,24719879,24719879,7719879,7719879
117,The Chronicles of Narnia: The Voyage of the Dawn Treader,"Dec 10, 2010",2010,113.0,"Adventure,Family,Fantasy",6.3,129663,155000000,104386950,418186950,-50613050,263186950
118,The Adventures of Tintin,"Dec 21, 2011",2011,107.0,"Action,Adventure,Animation",7.3,202430,130000000,77591831,373993951,-52408169,243993951
119,Machete,"Sep 3, 2010",2010,105.0,"Action,Crime,Thriller",6.6,182320,12500000,26593646,46370970,14093646,33870970
120,Dear John,"Feb 5, 2010",2010,108.0,"Drama,Romance,War",6.3,128657,25000000,80014842,142033509,55014842,117033509
121,The Green Hornet,"Jan 14, 2011",2011,119.0,"Action,Comedy,Crime",5.8,148622,110000000,98780042,229155503,-11219958,119155503
122,Hanna,"Apr 8, 2011",2011,111.0,"Action,Drama,Thriller",6.8,179178,30000000,40259119,65343694,10259119,35343694
123,The Wolf of Wall Street,"Dec 25, 2013",2013,180.0,"Biography,Crime,Drama",8.2,1035358,100000000,116900694,389870414,16900694,289870414
124,Megamind,"Nov 5, 2010",2010,95.0,"Action,Animation,Comedy",7.3,207488,130000000,148415853,321887208,18415853,191887208
128,Knight and Day,"Jun 23, 2010",2010,109.0,"Action,Adventure,Comedy",6.3,169840,117000000,76423035,258751370,-40576965,141751370
129,Alice in Wonderland,"Mar 5, 2010",2010,108.0,"Adventure,Family,Fantasy",6.5,358813,200000000,334191110,1025491110,134191110,825491110
130,Alice in Wonderland,"Mar 5, 2010",2010,99.0,"Fantasy,Musical",6.5,6,200000000,334191110,1025491110,134191110,825491110
132,Argo,"Oct 12, 2012",2012,120.0,"Biography,Drama,Thriller",7.7,534683,44500000,136025503,227140757,91525503,182640757
133,Secretariat,"Oct 8, 2010",2010,123.0,"Biography,Drama,Family",7.2,24536,35000000,59699513,60376247,24699513,25376247
134,Poltergeist,"May 22, 2015",2015,93.0,"Horror,Thriller",4.9,51538,35000000,47425125,95713069,12425125,60713069
137,Kidnap,"Aug 4, 2017",2017,95.0,"Crime,Drama,Thriller",5.9,28898,21000000,30718107,34836080,9718107,13836080
138,The Descendants,"Nov 16, 2011",2011,115.0,"Comedy,Drama",7.3,223464,20000000,82624961,175507800,62624961,155507800
140,The Eagle,"Feb 11, 2011",2011,114.0,"Action,Adventure,Drama",6.2,61475,25000000,19490041,38993548,-5509959,13993548
141,The Book of Eli,"Jan 15, 2010",2010,118.0,"Action,Adventure,Drama",6.9,271307,80000000,94835059,158750817,14835059,78750817
142,Legion,"Jan 22, 2010",2010,100.0,"Action,Fantasy,Horror",5.2,92709,26000000,40168080,67647574,14168080,41647574
143,The Bounty Hunter,"Mar 19, 2010",2010,110.0,"Action,Comedy,Romance",5.6,112444,45000000,67061228,135808837,22061228,90808837
144,The Bounty Hunter,"Mar 19, 2010",2010,,,6.3,29,45000000,67061228,135808837,22061228,90808837
145,Silver Linings Playbook,"Nov 16, 2012",2012,122.0,"Comedy,Drama,Romance",7.7,621018,21000000,132092958,236412453,111092958,215412453
146,Parental Guidance,"Dec 25, 2012",2012,105.0,"Comedy,Family",6.1,23711,25000000,77267296,120832383,52267296,95832383
147,Goosebumps,"Oct 16, 2015",2015,103.0,"Adventure,Comedy,Family",6.3,72858,58000000,80069458,158905324,22069458,100905324
148,Life as We Know It,"Oct 8, 2010",2010,114.0,"Comedy,Drama,Romance",6.6,113077,38000000,53374681,105887837,15374681,67887837
149,Boyhood,"Jul 11, 2014",2014,165.0,Drama,7.9,315584,4000000,25379975,57273049,21379975,53273049
150,Water for Elephants,"Apr 22, 2011",2011,120.0,"Drama,Romance",6.9,105812,38000000,58709717,116809717,20709717,78809717
151,Monte Carlo,"Jul 1, 2011",2011,109.0,"Adventure,Comedy,Family",5.8,38731,20000000,23186769,39686769,3186769,19686769
152,Footloose,"Oct 14, 2011",2011,113.0,"Comedy,Drama,Music",5.9,43251,24000000,51802742,62989834,27802742,38989834
155,Winchester,"Feb 2, 2018",2018,99.0,"Biography,Drama,Fantasy",5.4,24351,3500000,25091816,44378040,21591816,40878040
156,Skyfall,"Nov 8, 2012",2012,143.0,"Action,Adventure,Thriller",7.8,592221,200000000,304360277,1110526981,104360277,910526981
157,Dark Shadows,"May 11, 2012",2012,113.0,"Comedy,Fantasy,Horror",6.2,229818,150000000,79727149,238202668,-70272851,88202668
162,Lights Out,"Jul 22, 2016",2016,81.0,"Drama,Horror,Mystery",6.3,100650,5000000,67268835,148806510,62268835,143806510
163,Blended,"May 23, 2014",2014,117.0,"Comedy,Romance",6.5,106491,45000000,46290741,127990741,1290741,82990741
164,Lone Survivor,"Dec 25, 2013",2013,121.0,"Action,Biography,Drama",7.5,246641,40000000,125095601,149804632,85095601,109804632
166,Noah,"Mar 28, 2014",2014,138.0,"Action,Adventure,Drama",5.8,229326,130000000,101200044,352831065,-28799956,222831065
168,Paul,"Mar 18, 2011",2011,104.0,"Adventure,Comedy,Sci-Fi",7.0,220567,40000000,37412945,101162106,-2587055,61162106
170,The Darkest Hour,"Dec 25, 2011",2011,89.0,"Action,Adventure,Horror",4.9,55071,34800000,21443494,62831715,-13356506,28031715
172,Killers,"Jun 4, 2010",2010,100.0,"Action,Comedy,Romance",5.4,82237,75000000,47059963,95572749,-27940037,20572749
177,Trance,"Apr 5, 2013",2013,101.0,"Crime,Drama,Mystery",6.9,104951,16000000,2322593,22594052,-13677407,6594052
178,Jackass 3D,"Oct 15, 2010",2010,95.0,"Action,Comedy,Documentary",7.0,53289,20000000,117229692,171685793,97229692,151685793
179,Blue Valentine,"Dec 29, 2010",2010,112.0,"Drama,Romance",7.4,170089,1000000,9737892,16566240,8737892,15566240
181,The Ides of March,"Oct 7, 2011",2011,101.0,"Drama,Thriller",7.1,207417,23000000,40962534,77735925,17962534,54735925
182,Big Eyes,"Dec 25, 2014",2014,106.0,"Biography,Crime,Drama",7.0,77447,10000000,14482031,27317872,4482031,17317872
183,Big Eyes,"Dec 25, 2014",2014,,Documentary,7.2,43,10000000,14482031,27317872,4482031,17317872
184,Burlesque,"Nov 24, 2010",2010,119.0,"Drama,Music,Musical",6.4,71021,55000000,39440655,90552675,-15559345,35552675
185,Burlesque,"Nov 24, 2010",2010,,Drama,7.0,45,55000000,39440655,90552675,-15559345,35552675
186,Morning Glory,"Nov 10, 2010",2010,107.0,"Comedy,Drama,Romance",6.5,67367,40000000,31011732,59795070,-8988268,19795070
187,Shutter Island,"Feb 19, 2010",2010,138.0,"Mystery,Thriller",8.1,1005960,80000000,128012934,299461782,48012934,219461782
188,Green Lantern,"Jun 17, 2011",2011,114.0,"Action,Adventure,Sci-Fi",5.5,252281,200000000,116601172,219535492,-83398828,19535492
189,Takers,"Aug 27, 2010",2010,107.0,"Action,Crime,Thriller",6.2,53377,32000000,57744720,70587268,25744720,38587268
190,Death Wish,"Mar 2, 2018",2018,107.0,"Action,Crime,Drama",6.4,50279,30000000,34017028,48575965,4017028,18575965
191,The Ghost Writer,"Feb 19, 2010",2010,128.0,"Drama,Mystery,Thriller",7.2,148274,45000000,15541549,65532491,-29458451,20532491
192,Frankenweenie,"Oct 5, 2012",2012,87.0,"Animation,Comedy,Family",7.0,89489,39000000,35287788,81150788,-3712212,42150788
193,Beastly,"Mar 4, 2011",2011,86.0,"Drama,Fantasy,Romance",5.6,72599,17000000,27865571,38028230,10865571,21028230
194,The Karate Kid,"Jun 11, 2010",2010,140.0,"Action,Drama,Family",6.2,146401,40000000,176591618,351774938,136591618,311774938
196,The Rite,"Jan 28, 2011",2011,114.0,"Drama,Horror,Mystery",6.0,85604,37000000,33047633,97143987,-3952367,60143987
197,The Hobbit: The Desolation of Smaug,"Dec 13, 2013",2013,161.0,"Adventure,Fantasy",7.8,565563,250000000,258366855,960366855,8366855,710366855
198,Baggage Claim,"Sep 27, 2013",2013,96.0,Comedy,5.1,8296,8500000,21569509,22885836,13069509,14385836
199,A Walk in the Woods,"Sep 2, 2015",2015,104.0,"Adventure,Biography,Comedy",6.3,22033,8000000,29499394,37119358,21499394,29119358
200,A Nightmare on Elm Street,"Apr 30, 2010",2010,95.0,"Crime,Drama,Horror",5.2,85497,35000000,63075011,117729621,28075011,82729621
202,10 Cloverfield Lane,"Mar 11, 2016",2016,103.0,"Drama,Horror,Mystery",7.2,260383,5000000,72082999,108286422,67082999,103286422
203,You Will Meet a Tall Dark Stranger,"Sep 22, 2010",2010,98.0,"Comedy,Drama,Romance",6.3,41608,15000000,3247816,34247816,-11752184,19247816
204,The Lincoln Lawyer,"Mar 18, 2011",2011,118.0,"Crime,Drama,Thriller",7.3,196109,40000000,58009200,87145086,18009200,47145086
205,Rango,"Mar 4, 2011",2011,107.0,"Adventure,Animation,Comedy",7.2,215761,135000000,123477607,245724600,-11522393,110724600
206,Step Up 3D,"Aug 6, 2010",2010,107.0,"Drama,Music,Romance",6.2,53081,30000000,42400223,165889117,12400223,135889117
207,The Bourne Legacy,"Aug 10, 2012",2012,135.0,"Action,Adventure,Thriller",6.7,268678,125000000,113203870,280355920,-11796130,155355920
208,The Five-Year Engagement,"Apr 27, 2012",2012,124.0,"Comedy,Romance",6.2,88469,30000000,28700285,61623819,-1299715,31623819
209,Diary of a Wimpy Kid,"Mar 19, 2010",2010,94.0,"Comedy,Drama,Family",6.2,38640,15000000,64003625,76954311,49003625,61954311
210,Kites,"May 21, 2010",2010,123.0,"Action,Drama,Romance",6.1,11353,9200000,1685269,17155193,-7514731,7955193
211,The Muppets,"Nov 23, 2011",2011,103.0,"Adventure,Comedy,Family",7.1,82752,45000000,88625922,160971922,43625922,115971922
212,Last Vegas,"Jan 28, 2013",2013,105.0,"Comedy,Drama",6.6,121409,28000000,63914167,112914167,35914167,84914167
213,Ouija,"Oct 24, 2014",2014,89.0,"Horror,Mystery,Thriller",4.5,44054,5000000,50856010,103300632,45856010,98300632
214,Jack Ryan: Shadow Recruit,"Jan 17, 2014",2014,105.0,"Action,Drama,Thriller",6.2,114913,60000000,50577412,131377412,-9422588,71377412
216,Moneyball,"Sep 23, 2011",2011,133.0,"Biography,Drama,Sport",7.6,326657,50000000,75605492,111300835,25605492,61300835
217,Doctor Strange,"Nov 4, 2016",2016,115.0,"Action,Adventure,Fantasy",7.5,514510,165000000,232641920,676404566,67641920,511404566
218,Middle of Nowhere,"Oct 12, 2012",2012,97.0,Drama,6.4,1406,200000,236806,236806,36806,36806
219,Escape Plan,"Oct 18, 2013",2013,115.0,"Action,Crime,Mystery",6.7,211587,70000000,25135965,103735965,-44864035,33735965
220,Hereafter,"Oct 15, 2010",2010,129.0,"Drama,Fantasy,Romance",6.5,87288,50000000,32746941,108660270,-17253059,58660270
221,The Back-up Plan,"Apr 23, 2010",2010,104.0,"Comedy,Romance",5.4,46128,35000000,37490007,75281179,2490007,40281179
222,Lawless,"Aug 29, 2012",2012,116.0,"Crime,Drama",7.3,214055,26000000,37397291,54393687,11397291,28393687
223,First Man,"Oct 12, 2018",2018,141.0,"Biography,Drama,History",7.4,120009,60000000,44936545,105203825,-15063455,45203825
225,The World's End,"Aug 23, 2013",2013,109.0,"Action,Comedy,Sci-Fi",7.0,235308,20000000,26004851,47508505,6004851,27508505
226,Cars 2,"Jun 24, 2011",2011,106.0,"Adventure,Animation,Comedy",6.2,138914,200000000,191450875,560155383,-8549125,360155383
227,Kill the Messenger,"Oct 10, 2014",2014,112.0,"Biography,Crime,Drama",7.0,41231,5000000,2450846,6656705,-2549154,1656705
228,Leap Year,"Jan 8, 2010",2010,100.0,"Comedy,Romance",6.5,86125,19000000,25918920,32618920,6918920,13618920
229,Brave,"Jun 22, 2012",2012,93.0,"Adventure,Animation,Comedy",7.1,338728,185000000,237282182,554606532,52282182,369606532
230,Limitless,"Mar 18, 2011",2011,105.0,"Mystery,Sci-Fi,Thriller",7.4,492490,27000000,79249455,155564919,52249455,128564919
233,Legend of the Guardians: The Owls of Ga'Hoole,"Sep 24, 2010",2010,97.0,"Action,Adventure,Animation",7.0,73790,100000000,55675313,139716717,-44324687,39716717
234,Ghost in the Shell,"Mar 31, 2017",2017,107.0,"Action,Drama,Sci-Fi",6.4,176499,110000000,40563557,167910690,-69436443,57910690
235,Resident Evil: Afterlife,"Sep 10, 2010",2010,96.0,"Action,Adventure,Horror",5.9,153270,57500000,60128566,295874190,2628566,238374190
236,Zookeeper,"Jul 8, 2011",2011,102.0,"Comedy,Family,Romance",5.2,52396,80000000,80360866,170805525,360866,90805525
238,Get Him to the Greek,"Jun 4, 2010",2010,109.0,"Adventure,Comedy,Music",6.4,161653,40000000,61153526,91455875,21153526,51455875
239,Edge of Darkness,"Jan 29, 2010",2010,117.0,"Crime,Drama,Mystery",6.6,84753,60000000,43313890,82812456,-16686110,22812456
241,Iron Man 2,"May 7, 2010",2010,124.0,"Action,Adventure,Sci-Fi",7.0,657690,170000000,312433331,621156389,142433331,451156389
242,Let Me In,"Oct 1, 2010",2010,116.0,"Drama,Fantasy,Horror",7.1,107012,20000000,12134935,28270399,-7865065,8270399
244,Anchorman 2: The Legend Continues,"Dec 18, 2013",2013,119.0,Comedy,6.3,156116,50000000,127352707,172185754,77352707,122185754
245,A Turtle's Tale: Sammy's Adventures,"Dec 31, 2010",2010,88.0,"Adventure,Animation,Family",6.1,6310,25000000,0,71594792,-25000000,46594792
246,Due Date,"Nov 5, 2010",2010,95.0,"Adventure,Comedy",6.5,303523,65000000,100539043,211739043,35539043,146739043
247,Hot Tub Time Machine,"Mar 26, 2010",2010,101.0,"Comedy,Sci-Fi",6.4,153962,36000000,50269859,65967750,14269859,29967750
248,That's My Boy,"Jun 15, 2012",2012,116.0,Comedy,5.6,83009,57500000,36931089,58085235,-20568911,585235
249,21 Jump Street,"Mar 16, 2012",2012,109.0,"Action,Comedy,Crime",7.2,477771,42000000,138447667,202812429,96447667,160812429
250,RoboCop,"Feb 12, 2014",2014,117.0,"Action,Crime,Sci-Fi",6.2,205798,120000000,58607007,242981799,-61392993,122981799
252,The Future,"Jul 29, 2011",2011,91.0,"Drama,Fantasy,Romance",6.2,7648,1000000,568662,1239174,-431338,239174
254,The Tourist,"Dec 10, 2010",2010,103.0,"Action,Adventure,Thriller",6.0,206714,100000000,67631157,278731369,-32368843,178731369
256,Snatched,"May 12, 2017",2017,90.0,"Action,Adventure,Comedy",4.5,29997,42000000,45852178,57852177,3852178,15852177
260,Unforgettable,"Apr 21, 2017",2017,100.0,"Drama,Thriller",5.1,11489,12000000,11368012,16221211,-631988,4221211
261,Kick-Ass,"Apr 16, 2010",2010,117.0,"Action,Comedy",7.6,497363,28000000,48071303,97531134,20071303,69531134
262,300: Rise of an Empire,"Mar 7, 2014",2014,102.0,"Action,Fantasy,War",6.2,262978,110000000,106580051,330780051,-3419949,220780051
263,Immortals,"Nov 11, 2011",2011,110.0,"Action,Drama,Fantasy",6.0,152992,75000000,83504017,211562435,8504017,136562435
266,Incendies,"Sep 17, 2010",2010,131.0,"Drama,Mystery,War",8.3,124156,6800000,6857096,16038343,57096,9238343
267,The Man with the Iron Fists,"Nov 2, 2012",2012,95.0,Action,5.4,58185,15000000,15634090,22018988,634090,7018988
269,Den of Thieves,"Jan 19, 2018",2018,140.0,"Action,Crime,Drama",7.0,69648,30000000,44947622,80131391,14947622,50131391
270,Sex and the City 2,"May 27, 2010",2010,146.0,"Comedy,Drama,Romance",4.4,69199,95000000,95347692,294680778,347692,199680778
271,Scream 4,"Apr 15, 2011",2011,111.0,"Horror,Mystery",6.2,118779,40000000,38180928,95989590,-1819072,55989590
272,The Roommate,"Feb 4, 2011",2011,91.0,"Drama,Thriller",4.9,33062,16000000,37300107,52545707,21300107,36545707
273,Hercules,"Jul 25, 2014",2014,98.0,"Action,Adventure,Fantasy",6.0,137287,100000000,72688614,243388614,-27311386,143388614
275,Hercules,"Jul 25, 2014",2014,112.0,Comedy,6.2,72,100000000,72688614,243388614,-27311386,143388614
277,A Very Harold & Kumar 3D Christmas,"Nov 4, 2011",2011,90.0,"Adventure,Comedy",6.3,62151,20000000,35061031,36265745,15061031,16265745
279,Venom,"Oct 5, 2018",2018,112.0,"Action,Sci-Fi,Thriller",6.7,275406,116000000,213511408,853628605,97511408,737628605
281,2 Guns,"Aug 2, 2013",2013,109.0,"Action,Comedy,Crime",6.7,182025,61000000,75612460,132493015,14612460,71493015
282,The Spy Next Door,"Jan 15, 2010",2010,94.0,"Action,Comedy,Family",5.5,36767,28000000,24307106,46752858,-3692894,18752858
283,Looper,"Sep 28, 2012",2012,113.0,"Action,Crime,Drama",7.4,500595,30000000,66486205,170466405,36486205,140466405
284,Madagascar 3: Europe's Most Wanted,"Jun 8, 2012",2012,93.0,"Adventure,Animation,Comedy",6.8,146858,145000000,216391482,746921271,71391482,601921271
285,Date Night,"Apr 9, 2010",2010,88.0,"Comedy,Crime,Romance",6.3,144683,55000000,98711404,152269033,43711404,97269033
286,Easy A,"Sep 17, 2010",2010,92.0,"Comedy,Drama,Romance",7.1,330125,8000000,58401464,76200721,50401464,68200721
287,Bad Teacher,"Jun 24, 2011",2011,92.0,"Comedy,Romance",5.7,181189,19000000,100292856,215448997,81292856,196448997
288,The Strangers: Prey at Night,"Mar 9, 2018",2018,85.0,Horror,5.2,21614,5000000,24431472,29960051,19431472,24960051
289,The Social Network,"Oct 1, 2010",2010,120.0,"Biography,Drama",7.7,568578,40000000,96962694,224922135,56962694,184922135
290,Cats & Dogs: The Revenge of Kitty Galore,"Jul 30, 2010",2010,82.0,"Action,Comedy,Family",4.3,12642,85000000,43585753,113026383,-41414247,28026383
291,Evil Dead,"Apr 5, 2013",2013,91.0,"Fantasy,Horror,Thriller",6.5,146399,17000000,54239856,97778356,37239856,80778356
292,Ghostbusters,"Jul 15, 2016",2016,116.0,"Action,Comedy,Fantasy",5.2,186788,144000000,128350574,229008658,-15649426,85008658
294,N-Secure,"Oct 15, 2010",2010,105.0,"Crime,Drama,Thriller",3.6,587,1600000,2595644,2595644,995644,995644
295,Teenage Mutant Ninja Turtles,"Aug 8, 2014",2014,101.0,"Action,Adventure,Comedy",5.8,192220,125000000,191204754,485004754,66204754,360004754
297,xXx: Return of Xander Cage,"Jan 20, 2017",2017,107.0,"Action,Adventure,Thriller",5.2,77976,85000000,44898413,345033359,-40101587,260033359
298,The Last Song,"Mar 31, 2010",2010,107.0,"Drama,Music,Romance",6.0,74914,20000000,62950384,92678948,42950384,72678948
299,The Watch,"Jul 27, 2012",2012,102.0,"Action,Comedy,Horror",5.7,115757,55000000,34353000,67130045,-20647000,12130045
300,Pirates of the Caribbean: On Stranger Tides,"May 20, 2011",2011,136.0,"Action,Adventure,Fantasy",6.6,447624,410600000,241063875,1045663875,-169536125,635063875
301,Kung Fu Panda 2,"May 26, 2011",2011,90.0,"Action,Adventure,Animation",7.2,228465,150000000,165249063,664837547,15249063,514837547
302,Yogi Bear,"Dec 17, 2010",2010,80.0,"Adventure,Animation,Comedy",4.6,18934,80000000,100246011,204774690,20246011,124774690
303,Our Family Wedding,"Mar 12, 2010",2010,103.0,"Comedy,Romance",4.9,6417,14000000,20255281,21410546,6255281,7410546
304,50/50,"Sep 30, 2011",2011,100.0,"Comedy,Drama,Romance",7.7,300475,8000000,35016118,41334735,27016118,33334735
306,Seeking a Friend for the End of the World,"Jun 22, 2012",2012,101.0,"Adventure,Comedy,Drama",6.7,102047,10000000,7078738,11766959,-2921262,1766959
307,Animal Kingdom,"Aug 13, 2010",2010,113.0,"Crime,Drama",7.3,51576,4200000,1044039,8078683,-3155961,3878683
308,Devil,"Sep 17, 2010",2010,80.0,"Horror,Mystery,Thriller",6.2,122080,10000000,33679655,63354114,23679655,53354114
309,Rise of the Planet of the Apes,"Aug 5, 2011",2011,105.0,"Action,Drama,Sci-Fi",7.6,473020,93000000,176760185,470986200,83760185,377986200
310,The Last Exorcism,"Aug 27, 2010",2010,87.0,"Drama,Horror,Thriller",5.6,45815,1800000,41034350,70165900,39234350,68365900
311,The Expendables,"Aug 13, 2010",2010,103.0,"Action,Adventure,Thriller",6.5,307897,82000000,103068524,268268174,21068524,186268174
312,Gulliver's Travels,"Dec 25, 2010",2010,85.0,"Adventure,Comedy,Family",4.9,61178,112000000,42779261,232017848,-69220739,120017848
313,The Reef,"Dec 31, 2010",2010,94.0,"Adventure,Drama,Horror",5.8,15194,10000000,0,15037867,-10000000,5037867
314,Death at a Funeral,"Apr 16, 2010",2010,92.0,Comedy,5.7,42042,21000000,42739347,48977233,21739347,27977233
317,Gangster Squad,"Jan 11, 2013",2013,113.0,"Action,Crime,Drama",6.7,195560,60000000,46000903,104100903,-13999097,44100903
318,August: Osage County,"Dec 25, 2013",2013,121.0,"Comedy,Drama",7.2,79383,25000000,37738810,50738810,12738810,25738810
319,Going the Distance,"Sep 3, 2010",2010,102.0,"Comedy,Romance",6.3,54421,32000000,17804299,43603990,-14195701,11603990
321,Frozen,"Nov 22, 2013",2013,102.0,"Adventure,Animation,Comedy",7.5,516998,150000000,400738009,1272469910,250738009,1122469910
322,Despicable Me,"Jul 9, 2010",2010,95.0,"Animation,Comedy,Family",7.7,464511,69000000,251513985,543464573,182513985,474464573
323,The Twilight Saga: Eclipse,"Jun 30, 2010",2010,124.0,"Adventure,Drama,Fantasy",5.0,211733,68000000,300531751,706102828,232531751,638102828
324,The Lucky One,"Apr 20, 2012",2012,101.0,"Drama,Romance",6.5,94359,25000000,60457138,96633833,35457138,71633833
325,Cyrus,"Jun 18, 2010",2010,87.0,"Crime,Horror,Mystery",4.7,944,7000000,7468936,10062896,468936,3062896
326,Cyrus,"Jun 18, 2010",2010,91.0,"Comedy,Drama,Romance",6.3,32457,7000000,7468936,10062896,468936,3062896
327,Movie 43,"Jan 25, 2013",2013,94.0,Comedy,4.3,92980,10000000,8840453,31164747,-1159547,21164747
328,Arthur,"Apr 8, 2011",2011,110.0,"Comedy,Romance",5.7,49013,40000000,33035397,47787943,-6964603,7787943
329,Tinker Tailor Soldier Spy,"Dec 9, 2011",2011,122.0,"Drama,Mystery,Thriller",7.1,174890,21000000,24149393,81452811,3149393,60452811
330,The Great Gatsby,"May 10, 2013",2013,143.0,"Drama,Romance",7.3,433165,190000000,144840419,351040419,-45159581,161040419
332,The Dark Knight Rises,"Jul 20, 2012",2012,164.0,"Action,Thriller",8.4,1387769,275000000,448139099,1084439099,173139099,809439099
333,Jack the Giant Slayer,"Mar 1, 2013",2013,114.0,"Adventure,Fantasy",6.3,123127,195000000,65187603,197687603,-129812397,2687603
334,If I Stay,"Aug 22, 2014",2014,107.0,"Drama,Fantasy,Music",6.8,107625,11000000,50474843,78356170,39474843,67356170
335,Passengers,"Dec 21, 2016",2016,116.0,"Drama,Romance,Sci-Fi",7.0,311083,110000000,100014699,302239672,-9985301,192239672
336,Black Mass,"Sep 18, 2015",2015,123.0,"Biography,Crime,Drama",6.9,155847,53000000,62575678,98837872,9575678,45837872
337,Tomb Raider,"Mar 16, 2018",2018,119.0,"Action,Adventure,Fantasy",6.3,163560,90000000,58250803,273477501,-31749197,183477501
339,The Sitter,"Dec 9, 2011",2011,81.0,Comedy,5.7,65575,25000000,30542576,38749404,5542576,13749404
340,The Cold Light of Day,"Sep 7, 2012",2012,93.0,"Action,Thriller",4.9,33039,20000000,3763583,25361206,-16236417,5361206
341,Cloud Atlas,"Oct 26, 2012",2012,172.0,"Action,Drama,Mystery",7.4,326473,102000000,27108272,130673154,-74891728,28673154
342,Made in Dagenham,"Nov 19, 2010",2010,113.0,"Biography,Comedy,Drama",7.2,13121,8000000,1095369,15644196,-6904631,7644196
348,Inception,"Jul 16, 2010",2010,148.0,"Action,Adventure,Sci-Fi",8.8,1841066,160000000,292576195,835524642,132576195,675524642
349,Grown Ups,"Jun 25, 2010",2010,102.0,Comedy,6.0,210377,75000000,162001186,272223430,87001186,197223430
350,The Adjustment Bureau,"Mar 4, 2011",2011,106.0,"Romance,Sci-Fi,Thriller",7.1,227616,50200000,62495645,126931325,12295645,76731325
351,Cop Out,"Feb 26, 2010",2010,107.0,"Action,Comedy,Crime",5.6,81656,37000000,44875481,55909910,7875481,18909910
352,The Other Guys,"Aug 6, 2010",2010,107.0,"Action,Comedy,Crime",6.7,221664,100000000,119219978,170936470,19219978,70936470
353,Suicide Squad,"Aug 5, 2016",2016,123.0,"Action,Adventure,Fantasy",6.0,533039,175000000,325100054,746059887,150100054,571059887
354,Total Recall,"Aug 3, 2012",2012,118.0,"Action,Adventure,Mystery",6.3,228460,125000000,58877969,211856088,-66122031,86856088
356,We Bought a Zoo,"Dec 23, 2011",2011,124.0,"Comedy,Drama,Family",7.1,126849,50000000,75624550,118729073,25624550,68729073
357,When the Bough Breaks,"Sep 9, 2016",2016,107.0,"Crime,Drama,Horror",5.1,4729,10000000,29747603,30768449,19747603,20768449
359,Why Did I Get Married Too?,"Apr 2, 2010",2010,121.0,"Comedy,Drama,Romance",4.6,8653,20000000,60095852,60831067,40095852,40831067
360,The Hunger Games,"Mar 23, 2012",2012,142.0,"Action,Adventure,Sci-Fi",7.2,795227,80000000,408010692,677923379,328010692,597923379
361,Mad Max: Fury Road,"May 15, 2015",2015,120.0,"Action,Adventure,Sci-Fi",8.1,780910,150000000,153636354,370098020,3636354,220098020
362,Marmaduke,"Jun 4, 2010",2010,87.0,"Comedy,Family",4.2,13283,50000000,33644788,89895930,-16355212,39895930
363,Prisoners,"Sep 20, 2013",2013,153.0,"Crime,Drama,Mystery",8.1,526273,46000000,61002302,113402302,15002302,67402302
364,It,"Sep 8, 2017",2017,135.0,"Horror,Thriller",7.4,359123,35000000,327481748,697457969,292481748,662457969
365,Taken 2,"Oct 5, 2012",2012,92.0,"Action,Thriller",6.3,273106,45000000,139854287,377807404,94854287,332807404
366,Journey 2: The Mysterious Island,"Feb 10, 2012",2012,94.0,"Action,Adventure,Comedy",5.8,83507,79000000,103860290,318146162,24860290,239146162
367,Straight Outta Compton,"Aug 14, 2015",2015,147.0,"Biography,Drama,History",7.9,165307,28000000,161197785,202182981,133197785,174182981
368,Transformers: Dark of the Moon,"Jun 29, 2011",2011,154.0,"Action,Adventure,Sci-Fi",6.2,366409,195000000,352390543,1123790543,157390543,928790543
369,Winter's Bone,"Jun 11, 2010",2010,100.0,"Drama,Mystery",7.2,127751,2000000,6531503,16131551,4531503,14131551
370,Unknown,"Feb 18, 2011",2011,113.0,"Action,Mystery,Thriller",6.9,235167,40000000,63686397,136123083,23686397,96123083
372,Happy Feet Two,"Nov 18, 2011",2011,100.0,"Adventure,Animation,Comedy",5.9,38396,135000000,64006466,157956466,-70993534,22956466
373,True Grit,"Dec 22, 2010",2010,110.0,"Adventure,Drama,Western",7.6,284034,35000000,171243005,252276928,136243005,217276928
374,Remember Me,"Mar 12, 2010",2010,113.0,"Drama,Romance",7.1,129443,16000000,19068240,56506120,3068240,40506120
376,For Colored Girls,"Nov 5, 2010",2010,133.0,Drama,6.1,6728,21000000,37729698,38017873,16729698,17017873
377,Just Wright,"May 14, 2010",2010,100.0,"Comedy,Romance,Sport",5.9,12466,12000000,21540363,21867665,9540363,9867665
378,Star Trek Into Darkness,"May 16, 2013",2013,132.0,"Action,Adventure,Sci-Fi",7.7,445535,190000000,228778661,467381584,38778661,277381584
379,Ride Along,"Jan 17, 2014",2014,99.0,"Action,Comedy,Crime",6.2,94529,25000000,134202565,153733800,109202565,128733800
381,Men in Black 3,"May 25, 2012",2012,106.0,"Action,Adventure,Comedy",6.8,309879,215000000,179020854,654213485,-35979146,439213485
382,No Strings Attached,"Jan 21, 2011",2011,108.0,"Comedy,Romance",6.2,197663,25000000,70662220,149228078,45662220,124228078
383,Riddick,"Sep 6, 2013",2013,119.0,"Action,Adventure,Sci-Fi",6.4,144821,38000000,42025135,94763758,4025135,56763758
384,The Hangover Part II,"May 26, 2011",2011,102.0,"Comedy,Mystery",6.5,432800,80000000,254464305,586464305,174464305,506464305
385,Hop,"Apr 1, 2011",2011,95.0,"Adventure,Animation,Comedy",5.4,28893,63000000,108085305,188657593,45085305,125657593
387,12 Strong,"Jan 19, 2018",2018,130.0,"Action,Drama,History",6.6,50155,35000000,45819713,71118378,10819713,36118378
388,You Again,"Sep 24, 2010",2010,105.0,"Comedy,Family,Romance",5.8,46690,20000000,25702053,32838945,5702053,12838945
389,Nanny McPhee Returns,"Aug 20, 2010",2010,109.0,"Comedy,Family,Fantasy",6.1,25048,35000000,29197642,97799865,-5802358,62799865
390,"I, Frankenstein","Jan 24, 2014",2014,92.0,"Action,Fantasy,Horror",5.1,74910,65000000,19075290,74575290,-45924710,9575290
391,Somewhere,"Dec 22, 2010",2010,97.0,"Comedy,Drama",6.3,40250,7000000,1785645,17023121,-5214355,10023121
392,Predators,"Jul 9, 2010",2010,107.0,"Action,Adventure,Sci-Fi",6.4,199764,40000000,52000688,127234389,12000688,87234389
393,Hansel & Gretel: Witch Hunters,"Jan 25, 2013",2013,88.0,"Action,Fantasy,Horror",6.1,183387,50000000,55703475,214949716,5703475,164949716
394,The Wolverine,"Jul 26, 2013",2013,126.0,"Action,Adventure,Sci-Fi",6.7,401286,115000000,132556852,416456852,17556852,301456852
395,Arthur Christmas,"Nov 23, 2011",2011,97.0,"Adventure,Animation,Comedy",7.1,45439,85000000,46462469,149717124,-38537531,64717124
396,Brick Mansions,"Apr 25, 2014",2014,90.0,"Action,Crime",5.7,37528,28000000,20396829,73421224,-7603171,45421224
399,Deadpool,"Feb 12, 2016",2016,108.0,"Action,Adventure,Comedy",8.0,820847,58000000,363070709,801025593,305070709,743025593
400,Another Year,"Dec 29, 2010",2010,129.0,"Comedy,Drama",7.3,26273,8000000,3205706,20005613,-4794294,12005613
401,Faster,"Nov 24, 2010",2010,98.0,"Action,Crime,Drama",6.5,93618,24000000,23240020,35792945,-759980,11792945
403,Rio,"Apr 15, 2011",2011,96.0,"Adventure,Animation,Comedy",6.9,191621,90000000,143619809,487519809,53619809,397519809
407,Fright Night,"Aug 19, 2011",2011,106.0,"Comedy,Horror",6.4,94555,30000000,18298649,40520649,-11701351,10520649
408,Charlie St. Cloud,"Jul 30, 2010",2010,99.0,"Drama,Fantasy,Romance",6.5,55016,44000000,31206263,48478084,-12793737,4478084
409,Battleship,"May 18, 2012",2012,131.0,"Action,Adventure,Sci-Fi",5.8,225342,220000000,65233400,313477717,-154766600,93477717
412,The American,"Sep 1, 2010",2010,105.0,"Crime,Drama,Thriller",6.3,86863,20000000,35606376,67950723,15606376,47950723
413,Martha Marcy May Marlene,"Oct 21, 2011",2011,102.0,"Drama,Mystery,Thriller",6.9,45873,1000000,2981038,5438911,1981038,4438911
424,The Gift,"Aug 7, 2015",2015,108.0,"Drama,Mystery,Thriller",7.1,123834,5000000,43787265,58978477,38787265,53978477
431,Rise of the Guardians,"Nov 21, 2012",2012,97.0,"Action,Adventure,Animation",7.3,145281,145000000,103412758,306900902,-41587242,161900902
432,Prometheus,"Jun 8, 2012",2012,124.0,"Adventure,Mystery,Sci-Fi",7.0,538720,125000000,126477084,402448265,1477084,277448265
433,Winnie the Pooh,"Jul 15, 2011",2011,63.0,"Adventure,Animation,Comedy",7.2,19605,30000000,26692846,50145607,-3307154,20145607
434,Monsters University,"Jun 21, 2013",2013,104.0,"Adventure,Animation,Comedy",7.3,291887,200000000,268488329,743588329,68488329,543588329
435,The Help,"Aug 10, 2011",2011,146.0,Drama,8.1,392699,25000000,169705587,213120004,144705587,188120004
436,Gravity,"Oct 4, 2013",2013,91.0,"Drama,Sci-Fi,Thriller",7.7,710018,110000000,274092705,693698673,164092705,583698673
438,The Wall,"May 12, 2017",2017,88.0,"Action,Drama,Thriller",6.2,20391,3000000,1803064,4495262,-1196936,1495262
440,The Conjuring,"Jul 19, 2013",2013,112.0,"Horror,Mystery,Thriller",7.5,397233,20000000,137400141,318000141,117400141,298000141
441,The Next Three Days,"Nov 19, 2010",2010,133.0,"Action,Crime,Drama",7.4,168066,30000000,21148651,67255916,-8851349,37255916
443,Brooklyn,"Nov 4, 2015",2015,117.0,"Drama,Romance",7.5,117021,11000000,38322743,62076141,27322743,51076141
445,Letters to God,"Apr 9, 2010",2010,110.0,"Drama,Family",6.3,4443,3000000,2848587,3237452,-151413,237452
446,Buried,"Sep 24, 2010",2010,95.0,"Drama,Mystery,Thriller",7.0,139426,1987650,1044143,21270290,-943507,19282640
448,The Odd Life of Timothy Green,"Aug 15, 2012",2012,105.0,"Comedy,Drama,Family",6.6,42770,40000000,51853450,55249159,11853450,15249159
449,The Grandmaster,"Aug 23, 2013",2013,130.0,"Action,Biography,Drama",6.6,28781,38600000,6594959,57987299,-32005041,19387299
450,"Big Mommas: Like Father, Like Son","Feb 18, 2011",2011,107.0,"Action,Comedy,Crime",4.4,23520,32000000,37915414,82332450,5915414,50332450
452,Joy,"Dec 25, 2015",2015,124.0,Drama,6.6,118086,60000000,56451232,101134059,-3548768,41134059
455,Baywatch,"May 25, 2017",2017,116.0,"Action,Comedy,Crime",5.6,137528,60000000,58060186,175863783,-1939814,115863783
456,Monsters,"Oct 29, 2010",2010,94.0,"Drama,Sci-Fi,Thriller",6.4,84332,500000,237301,5639730,-262699,5139730
457,Saw 3D: The Final Chapter,"Oct 29, 2010",2010,90.0,"Crime,Horror,Mystery",5.6,83532,17000000,45710178,133735284,28710178,116735284
458,Aquaman,"Dec 21, 2018",2018,143.0,"Action,Adventure,Fantasy",7.1,263328,160000000,335061807,1146894640,175061807,986894640
459,Bridesmaids,"May 13, 2011",2011,125.0,"Comedy,Romance",6.8,249501,32500000,169211718,289632023,136711718,257132023
461,Logan,"Mar 3, 2017",2017,137.0,"Action,Drama,Sci-Fi",8.1,560270,127000000,226277068,615461394,99277068,488461394
462,Oblivion,"Apr 19, 2013",2013,124.0,"Action,Adventure,Sci-Fi",7.0,453966,120000000,89107235,287916633,-30892765,167916633
464,The Greatest Showman,"Dec 20, 2017",2017,105.0,"Biography,Drama,Musical",7.6,199663,84000000,174340174,386665550,90340174,302665550
465,Red Riding Hood,"Mar 11, 2011",2011,100.0,"Fantasy,Horror,Mystery",5.5,102369,42000000,37662162,91678442,-4337838,49678442
466,The Raven,"Apr 27, 2012",2012,110.0,"Crime,Mystery,Thriller",6.4,79578,26000000,16008272,30601801,-9991728,4601801
467,Khumba,"Dec 6, 2013",2013,85.0,"Adventure,Animation,Family",5.7,4984,15000000,0,20898221,-15000000,5898221
468,Zambezia,"Dec 31, 2012",2012,83.0,"Adventure,Animation,Comedy",5.8,6010,20000000,0,34454336,-20000000,14454336
469,The Change-Up,"Aug 5, 2011",2011,112.0,"Comedy,Fantasy",6.3,155374,52000000,37243418,75997067,-14756582,23997067
471,The Forest,"Jan 8, 2016",2016,93.0,"Horror,Mystery,Thriller",4.8,36423,10000000,26594261,40749230,16594261,30749230
472,The Forest,"Jan 8, 2016",2016,109.0,"Drama,Fantasy,Horror",6.5,222,10000000,26594261,40749230,16594261,30749230
473,Central Intelligence,"Jun 17, 2016",2016,107.0,"Action,Comedy,Crime",6.3,138872,50000000,127440871,217194805,77440871,167194805
474,The Lego Movie,"Feb 7, 2014",2014,100.0,"Action,Adventure,Animation",7.8,304179,60000000,257784718,457729388,197784718,397729388
476,Horrible Bosses,"Jul 8, 2011",2011,98.0,"Comedy,Crime",6.9,398695,35000000,117538559,212417601,82538559,177417601
479,Halloween,"Oct 19, 2018",2018,106.0,"Horror,Thriller",6.6,88395,10000000,159342015,254900667,149342015,244900667
481,Fantastic Four,"Aug 7, 2015",2015,100.0,"Action,Adventure,Drama",4.3,140148,120000000,56117548,167849187,-63882452,47849187
484,Le Havre,"Oct 21, 2011",2011,93.0,"Comedy,Drama",7.2,18490,5500000,611709,13480196,-4888291,7980196
485,The Three Musketeers,"Oct 21, 2011",2011,110.0,"Action,Adventure,Romance",5.8,98408,90000000,20377913,139877913,-69622087,49877913
486,Sherlock Holmes: A Game of Shadows,"Dec 16, 2011",2011,129.0,"Action,Adventure,Crime",7.5,394189,125000000,186848418,535663443,61848418,410663443
487,The Host,"Mar 29, 2013",2013,125.0,"Action,Adventure,Drama",5.9,105633,50000000,26623701,64477051,-23376299,14477051
489,Contraband,"Jan 13, 2012",2012,109.0,"Action,Crime,Drama",6.5,111709,25000000,66528000,98406855,41528000,73406855
490,The Vatican Tapes,"Jul 24, 2015",2015,91.0,"Horror,Thriller",5.0,14822,13000000,1784763,14929184,-11215237,1929184
491,Vacation,"Jul 29, 2015",2015,99.0,"Adventure,Comedy",6.1,87582,31000000,58884188,102306500,27884188,71306500
492,Melancholia,"Nov 11, 2011",2011,135.0,"Drama,Sci-Fi",7.2,153434,9400000,3030848,21817298,-6369152,12417298
497,Exodus: Gods and Kings,"Dec 12, 2014",2014,150.0,"Action,Adventure,Drama",6.0,150858,140000000,65014513,268314513,-74985487,128314513
498,Sea Rex 3D: Journey to a Prehistoric World,"May 28, 2010",2010,41.0,Documentary,6.9,364,5000000,6096582,16515203,1096582,11515203
500,Elysium,"Aug 9, 2013",2013,109.0,"Action,Drama,Sci-Fi",6.6,395572,120000000,93050117,286192091,-26949883,166192091
502,Captain Phillips,"Oct 11, 2013",2013,134.0,"Biography,Drama,Thriller",7.8,387402,55000000,107136417,220648184,52136417,165648184
503,Hope Springs,"Aug 8, 2012",2012,100.0,"Comedy,Drama,Romance",6.3,38667,30000000,63536011,133085295,33536011,103085295
504,Paranormal Activity 2,"Oct 20, 2010",2010,91.0,Horror,5.7,93122,3000000,84752907,177512032,81752907,174512032
505,The Mortal Instruments: City of Bones,"Aug 21, 2013",2013,130.0,"Action,Fantasy,Horror",5.9,121936,60000000,31165421,75965567,-28834579,15965567
506,Blair Witch,"Sep 16, 2016",2016,89.0,"Horror,Mystery,Thriller",5.0,36867,10000000,20777061,38985577,10777061,28985577
507,The Guard,"Jul 29, 2011",2011,96.0,"Comedy,Crime,Thriller",7.3,75183,6000000,5359774,21197454,-640226,15197454
508,Snow Flower and the Secret Fan,"Jul 15, 2011",2011,104.0,"Drama,History",6.1,3429,6000000,1348205,11348205,-4651795,5348205
509,127 Hours,"Nov 5, 2010",2010,94.0,"Adventure,Biography,Drama",7.6,323949,18000000,18335230,60217171,335230,42217171
511,Another Earth,"Jul 22, 2011",2011,92.0,"Drama,Romance,Sci-Fi",7.0,85839,175000,1321194,2102779,1146194,1927779
512,The Last Stand,"Jan 18, 2013",2013,107.0,"Action,Thriller",6.4,126623,30000000,12050299,48330757,-17949701,18330757
513,Country Strong,"Dec 22, 2010",2010,117.0,"Drama,Music",6.3,16296,15000000,20218921,20601987,5218921,5601987
515,Mary Queen of Scots,"Dec 7, 2018",2018,124.0,"Biography,Drama,History",6.3,23866,25000000,16468499,46734733,-8531501,21734733
516,Beautiful Creatures,"Feb 14, 2013",2013,124.0,"Drama,Fantasy,Romance",6.2,79764,50000000,19452138,60282876,-30547862,10282876
517,The Master,"Sep 14, 2012",2012,138.0,Drama,7.1,131365,37500000,16247159,50647416,-21252841,13147416
520,I Want Your Money,"Oct 15, 2010",2010,92.0,Documentary,5.1,1244,400000,433588,433588,33588,33588
521,One Day,"Aug 19, 2011",2011,107.0,"Drama,Romance",7.0,128094,15000000,13843771,59168692,-1156229,44168692
524,Overboard,"May 4, 2018",2018,112.0,"Comedy,Romance",5.9,25607,12000000,50316123,85369830,38316123,73369830
527,Dolphin Tale,"Sep 23, 2011",2011,113.0,"Drama,Family",6.9,20746,37000000,72286779,96068724,35286779,59068724
528,Skyline,"Nov 12, 2010",2010,92.0,"Action,Sci-Fi,Thriller",4.4,83710,10000000,21416355,68264973,11416355,58264973
529,Man on a Ledge,"Jan 27, 2012",2012,102.0,"Action,Adventure,Crime",6.6,137507,42000000,18620000,49621440,-23380000,7621440
530,The Girl with the Dragon Tattoo,"Dec 20, 2011",2011,158.0,"Crime,Drama,Mystery",7.8,387580,90000000,102515793,239373970,12515793,149373970
531,War Horse,"Dec 25, 2011",2011,146.0,"Drama,History,War",7.2,136447,70000000,79883359,156815529,9883359,86815529
532,Tiny Furniture,"Nov 12, 2010",2010,98.0,"Comedy,Drama,Romance",6.2,13397,50000,391674,424149,341674,374149
533,The Skeleton Twins,"Sep 12, 2014",2014,93.0,"Comedy,Drama,Romance",6.8,36793,1000000,5284309,5797192,4284309,4797192
534,Texas Chainsaw 3D,"Jan 4, 2013",2013,92.0,"Horror,Thriller",4.8,41784,20000000,34341945,47666013,14341945,27666013
535,Housefull,"Apr 30, 2010",2010,144.0,Comedy,5.5,11089,10100000,1183658,18726300,-8916342,8626300
537,The Dilemma,"Jan 14, 2011",2011,111.0,"Comedy,Drama",5.3,48148,70000000,48475290,70546865,-21524710,546865
538,House at the End of the Street,"Sep 21, 2012",2012,101.0,"Drama,Horror,Thriller",5.6,66303,6900000,31611916,44103982,24711916,37203982
539,Larry Crowne,"Jul 1, 2011",2011,98.0,"Comedy,Drama,Romance",6.1,58927,30000000,35608245,61449135,5608245,31449135
540,G.I. Joe: Retaliation,"Mar 27, 2013",2013,110.0,"Action,Adventure,Sci-Fi",5.8,165536,140000000,122523060,375740705,-17476940,235740705
541,What to Expect When You're Expecting,"May 18, 2012",2012,110.0,"Comedy,Drama,Romance",5.7,65890,37500000,41152203,88473016,3652203,50973016
542,Maleficent,"May 30, 2014",2014,97.0,"Action,Adventure,Family",7.0,305832,180000000,241407328,758536735,61407328,578536735
543,Warm Bodies,"Feb 1, 2013",2013,98.0,"Comedy,Horror,Romance",6.9,208709,30000000,66380662,115121608,36380662,85121608
544,The Commuter,"Jan 12, 2018",2018,105.0,"Action,Mystery,Thriller",6.3,83114,40000000,36343858,101985431,-3656142,61985431
546,Act of Valor,"Feb 24, 2012",2012,110.0,"Action,Adventure,Drama",6.5,63787,12000000,70012847,82497035,58012847,70497035
547,Lockout,"Apr 13, 2012",2012,95.0,"Action,Sci-Fi,Thriller",6.1,89554,20000000,14326865,33943049,-5673135,13943049
549,Norm of the North,"Jan 15, 2016",2016,90.0,"Adventure,Animation,Comedy",3.6,7951,18000000,17062499,30535660,-937501,12535660
550,Fast Five,"Apr 29, 2011",2011,130.0,"Action,Crime,Thriller",7.3,329892,125000000,210031325,630163454,85031325,505163454
551,Soul Surfer,"Apr 8, 2011",2011,112.0,"Biography,Drama,Family",7.1,41659,18000000,43853424,47158652,25853424,29158652
552,This Means War,"Feb 17, 2012",2012,103.0,"Action,Comedy,Romance",6.3,167438,65000000,54760791,156974557,-10239209,91974557
553,The Big Short,"Dec 11, 2015",2015,130.0,"Biography,Comedy,Drama",7.8,309227,28000000,70259870,133162752,42259870,105162752
554,The Woman in Black,"Feb 3, 2012",2012,95.0,"Drama,Fantasy,Horror",6.4,165357,15000000,54333290,128955898,39333290,113955898
556,Contagion,"Sep 9, 2011",2011,106.0,"Action,Drama,Thriller",6.6,201536,60000000,75658097,137551594,15658097,77551594
557,Safe House,"Feb 10, 2012",2012,115.0,"Action,Adventure,Crime",6.8,192655,85000000,126181630,208542162,41181630,123542162
558,Abduction,"Sep 23, 2011",2011,106.0,"Action,Mystery,Thriller",5.1,72552,35000000,28087155,86648359,-6912845,51648359
559,Abduction,"Sep 23, 2011",2011,84.0,"Horror,Thriller",5.2,10,35000000,28087155,86648359,-6912845,51648359
562,The Drop,"Sep 12, 2014",2014,106.0,"Crime,Drama",7.1,132161,12600000,10724389,19054534,-1875611,6454534
564,Albert Nobbs,"Dec 21, 2011",2011,113.0,"Drama,Romance",6.7,22213,7500000,3014696,8539003,-4485304,1039003
565,Amour,"Dec 19, 2012",2012,127.0,"Drama,Romance",7.9,84960,9700000,6738954,36787044,-2961046,27087044
566,Prom,"Apr 29, 2011",2011,104.0,"Comedy,Drama,Family",5.4,14279,8000000,10130219,10763183,2130219,2763183
567,American Reunion,"Apr 6, 2012",2012,113.0,Comedy,6.7,192250,50000000,56758835,236799211,6758835,186799211
569,The Visit,"Sep 11, 2015",2015,94.0,"Horror,Mystery,Thriller",6.2,102459,5000000,65206105,98677816,60206105,93677816
570,The Visit: An Alien Encounter,"Sep 11, 2015",2015,83.0,Documentary,6.0,661,5000000,65206105,98677816,60206105,93677816
571,Midnight in Paris,"May 20, 2011",2011,94.0,"Comedy,Fantasy,Romance",7.7,356500,30000000,56816662,162502774,26816662,132502774
572,A Good Day to Die Hard,"Feb 14, 2013",2013,98.0,"Action,Thriller",5.3,188383,92000000,67349198,304249198,-24650802,212249198
573,The Vow,"Feb 10, 2012",2012,104.0,"Drama,Romance",6.8,173629,30000000,125014030,197618160,95014030,167618160
577,Zoolander 2,"Feb 12, 2016",2016,101.0,Comedy,4.7,59914,50000000,28848693,55348693,-21151307,5348693
580,Abraham Lincoln: Vampire Hunter,"Jun 22, 2012",2012,105.0,"Action,Fantasy,Horror",5.9,142853,67500000,37519139,137489730,-29980861,69989730
583,Savages,"Jul 6, 2012",2012,131.0,"Crime,Drama,Thriller",6.5,115793,45000000,47323100,82513490,2323100,37513490
584,Margin Call,"Oct 21, 2011",2011,107.0,"Drama,Thriller",7.1,107264,3400000,5353586,20433227,1953586,17033227
585,The Foreigner,"Oct 13, 2017",2017,113.0,"Action,Thriller",7.0,81288,35000000,34393507,140783360,-606493,105783360
587,Alvin and the Chipmunks: Chipwrecked,"Dec 16, 2011",2011,87.0,"Adventure,Animation,Comedy",4.4,28158,80000000,133107389,349088523,53107389,269088523
588,J. Edgar,"Nov 9, 2011",2011,137.0,"Biography,Crime,Drama",6.6,115925,35000000,37306030,84606030,2306030,49606030
592,Jupiter Ascending,"Feb 6, 2015",2015,127.0,"Action,Adventure,Sci-Fi",5.3,166327,179000000,47482519,181982519,-131517481,2982519
593,Dum Maaro Dum,"Apr 22, 2011",2011,128.0,"Action,Crime,Drama",6.2,3616,5200000,564489,11633427,-4635511,6433427
594,The Last Witch Hunter,"Oct 23, 2015",2015,106.0,"Action,Adventure,Fantasy",6.0,86118,80000000,27367660,130818912,-52632340,50818912
595,Jackie,"Dec 2, 2016",2016,100.0,"Biography,Drama,History",6.7,66008,9000000,13960394,36588512,4960394,27588512
598,Animals United,"Dec 31, 2010",2010,93.0,"Adventure,Animation,Comedy",4.9,5340,30000000,0,53048539,-30000000,23048539
599,A Wrinkle in Time,"Mar 9, 2018",2018,109.0,"Adventure,Family,Fantasy",4.2,34888,103000000,100478608,133401882,-2521392,30401882
600,Free Birds,"Nov 1, 2013",2013,91.0,"Adventure,Animation,Comedy",5.9,20934,55000000,55750480,110387072,750480,55387072
601,Think Like a Man,"Apr 20, 2012",2012,122.0,"Comedy,Romance",6.6,41043,12000000,91547205,113373764,79547205,101373764
602,30 Minutes or Less,"Aug 12, 2011",2011,83.0,"Action,Comedy,Crime",6.1,87254,28000000,37053924,40966716,9053924,12966716
603,Final Destination 5,"Aug 12, 2011",2011,92.0,Horror,5.9,98061,40000000,42587643,155011165,2587643,115011165
604,Oz the Great and Powerful,"Mar 8, 2013",2013,130.0,"Adventure,Family,Fantasy",6.3,192045,200000000,234770996,490359051,34770996,290359051
605,ParaNorman,"Aug 17, 2012",2012,92.0,"Adventure,Animation,Comedy",7.0,87250,60000000,56003051,108119662,-3996949,48119662
606,Young Adult,"Dec 9, 2011",2011,94.0,"Comedy,Drama",6.3,74071,12000000,16311571,22750356,4311571,10750356
607,Independence Day: Resurgence,"Jun 24, 2016",2016,120.0,"Action,Adventure,Sci-Fi",5.2,155344,165000000,103144286,384169424,-61855714,219169424
608,Courageous,"Sep 30, 2011",2011,129.0,Drama,7.0,17586,2000000,34522221,35185884,32522221,33185884
609,Edge of Tomorrow,"Jun 6, 2014",2014,113.0,"Action,Sci-Fi",7.9,546284,178000000,100206256,370541256,-77793744,192541256
611,Creed,"Nov 25, 2015",2015,133.0,"Drama,Sport",7.6,224671,37000000,109767581,173567581,72767581,136567581
613,Friends with Benefits,"Jul 22, 2011",2011,109.0,"Comedy,Romance",6.6,317338,35000000,55802754,146595891,20802754,111595891
614,Underdogs,"Dec 31, 2013",2013,106.0,"Adventure,Animation,Family",6.5,8197,22000000,0,34061097,-22000000,12061097
615,Johnny English Reborn,"Oct 21, 2011",2011,101.0,"Action,Adventure,Comedy",6.3,110824,45000000,8406711,164640401,-36593289,119640401
616,Project X,"Mar 2, 2012",2012,88.0,Comedy,6.7,177782,12000000,54731865,103028188,42731865,91028188
617,In Time,"Oct 28, 2011",2011,109.0,"Action,Crime,Drama",6.7,346077,35000000,37553932,165103952,2553932,130103952
618,Our Idiot Brother,"Aug 26, 2011",2011,90.0,"Comedy,Drama",6.4,80738,5000000,24814830,25861249,19814830,20861249
619,Ted,"Jun 29, 2012",2012,106.0,"Comedy,Fantasy",6.9,538367,50000000,218665740,556016627,168665740,506016627
620,Jumping the Broom,"May 6, 2011",2011,112.0,"Comedy,Drama",5.7,9089,7000000,37295394,38158601,30295394,31158601
623,Inside Out,"Jun 19, 2015",2015,95.0,"Adventure,Animation,Comedy",8.2,536181,175000000,356461711,854235992,181461711,679235992
626,Inside Job,"Oct 8, 2010",2010,109.0,"Crime,Documentary",8.3,65304,2000000,4311834,7799257,2311834,5799257
627,The Dictator,"May 16, 2012",2012,83.0,Comedy,6.4,250976,65000000,59650222,180148897,-5349778,115148897
628,How to Train Your Dragon 2,"Jun 13, 2014",2014,102.0,"Action,Adventure,Animation",7.8,278205,145000000,177002924,614586270,32002924,469586270
630,Wrath of the Titans,"Mar 30, 2012",2012,99.0,"Action,Adventure,Fantasy",5.7,172330,150000000,83670083,305270083,-66329917,155270083
631,Million Dollar Arm,"May 16, 2014",2014,124.0,"Biography,Drama,Sport",7.0,41008,25000000,36447959,39217912,11447959,14217912
636,Here Comes the Boom,"Oct 12, 2012",2012,105.0,"Action,Comedy,Sport",6.4,81761,42000000,45290318,73239258,3290318,31239258
637,The Dark Tower,"Aug 4, 2017",2017,95.0,"Action,Adventure,Fantasy",5.7,107518,60000000,50701325,113461527,-9298675,53461527
638,Diary of a Wimpy Kid: Rodrick Rules,"Mar 25, 2011",2011,99.0,"Comedy,Family",6.6,23135,18000000,52698535,73695194,34698535,55695194
639,Super 8,"Jun 10, 2011",2011,112.0,"Mystery,Sci-Fi,Thriller",7.0,320575,50000000,127004179,257972745,77004179,207972745
640,Kick-Ass 2,"Aug 16, 2013",2013,103.0,"Action,Comedy,Crime",6.6,238832,28000000,28795985,63129909,795985,35129909
641,My Week with Marilyn,"Nov 23, 2011",2011,99.0,"Biography,Drama",7.0,79337,10000000,14597405,34240572,4597405,24240572
642,The Age of Adaline,"Apr 24, 2015",2015,112.0,"Drama,Fantasy,Romance",7.2,138924,30000000,42629776,68984536,12629776,38984536
643,The Artist,"Nov 25, 2011",2011,100.0,"Comedy,Drama,Romance",7.9,217184,16000000,44667095,128256712,28667095,112256712
644,The Artist,"Nov 25, 2011",2011,100.0,Thriller,6.8,6,16000000,44667095,128256712,28667095,112256712
645,Safe,"Apr 27, 2012",2012,94.0,"Action,Crime,Thriller",6.5,96388,33000000,17142080,41495213,-15857920,8495213
647,Colombiana,"Aug 26, 2011",2011,108.0,"Action,Drama,Thriller",6.4,87659,40000000,36665854,72295262,-3334146,32295262
648,The Perks of Being a Wallflower,"Sep 21, 2012",2012,103.0,Drama,8.0,422671,13000000,17742948,33069303,4742948,20069303
649,Cinderella,"Mar 13, 2015",2015,105.0,"Drama,Family,Fantasy",6.9,142792,95000000,201151353,534551353,106151353,439551353
651,Grudge Match,"Dec 25, 2013",2013,113.0,"Comedy,Drama,Sport",6.4,54080,40000000,29807260,69807260,-10192740,29807260
653,The Revenant,"Dec 25, 2015",2015,156.0,"Action,Adventure,Biography",8.0,621193,135000000,183637894,532938302,48637894,397938302
655,Pacific Rim,"Jul 12, 2013",2013,131.0,"Action,Adventure,Sci-Fi",6.9,443667,190000000,101802906,411002906,-88197094,221002906
656,All Eyez on Me,"Jun 16, 2017",2017,139.0,"Biography,Drama,Music",5.8,18541,45000000,44922302,54876855,-77698,9876855
657,Vampires Suck,"Aug 18, 2010",2010,82.0,Comedy,3.4,43984,20000000,36661504,81424988,16661504,61424988
658,Mirror Mirror,"Mar 30, 2012",2012,106.0,"Adventure,Comedy,Drama",5.6,79510,85000000,64935167,173613482,-20064833,88613482
659,Ice Age: Continental Drift,"Jul 13, 2012",2012,88.0,"Adventure,Animation,Comedy",6.6,175601,95000000,161321843,879765137,66321843,784765137
662,Home Run,"Apr 19, 2013",2013,113.0,"Drama,Sport",6.0,2745,1200000,2859955,2859955,1659955,1659955
663,Now You See Me,"May 31, 2013",2013,115.0,"Crime,Mystery,Thriller",7.3,553156,75000000,117723989,342769200,42723989,267769200
666,Entourage,"Jun 3, 2015",2015,104.0,Comedy,6.6,71519,30000000,32363404,46438538,2363404,16438538
667,Take Shelter,"Sep 30, 2011",2011,121.0,"Drama,Horror,Thriller",7.4,83200,4750000,1728953,4972016,-3021047,222016
668,Ready Player One,"Mar 29, 2018",2018,140.0,"Action,Adventure,Sci-Fi",7.5,301660,150000000,137690172,579290136,-12309828,429290136
669,Trolls,"Nov 4, 2016",2016,92.0,"Adventure,Animation,Comedy",6.5,63295,125000000,153707064,344150134,28707064,219150134
671,Stoker,"Mar 1, 2013",2013,99.0,"Drama,Thriller",6.8,97393,12000000,1703125,12034913,-10296875,34913
672,Circumstance,"Aug 26, 2011",2011,107.0,Drama,5.9,7055,900000,454121,958978,-445879,58978
673,Despicable Me 2,"Jul 3, 2013",2013,98.0,"Adventure,Animation,Comedy",7.4,344230,76000000,368065385,975216835,292065385,899216835
675,Before I Fall,"Mar 3, 2017",2017,98.0,"Drama,Fantasy,Mystery",6.4,39282,5000000,12241072,18945682,7241072,13945682
676,Carnage,"Dec 16, 2011",2011,80.0,"Comedy,Drama",7.2,111372,25000000,2546747,38112154,-22453253,13112154
680,The Guilt Trip,"Dec 19, 2012",2012,95.0,"Comedy,Drama",5.8,33702,40000000,37134215,41294674,-2865785,1294674
681,"Alexander and the Terrible, Horrible, No Good, Very Bad Day","Oct 10, 2014",2014,81.0,"Comedy,Family",6.2,37325,28000000,66954149,101379287,38954149,73379287
684,Captive,"Sep 18, 2015",2015,97.0,"Action,Crime,Drama",5.4,6017,2000000,2583301,2791973,583301,791973
686,Sausage Party,"Aug 12, 2016",2016,89.0,"Adventure,Animation,Comedy",6.2,159111,19000000,97670358,141344255,78670358,122344255
687,Casa de mi Padre,"Mar 16, 2012",2012,84.0,"Comedy,Western",5.5,19170,6000000,5909483,8446952,-90517,2446952
688,Safe Haven,"Feb 14, 2013",2013,115.0,"Drama,Romance,Thriller",6.7,97055,28000000,71399120,94050951,43399120,66050951
689,Justin Bieber: Never Say Never,"Feb 11, 2011",2011,105.0,"Documentary,Music",1.6,74978,13000000,73013910,99034125,60013910,86034125
690,Grave Encounters,"Sep 9, 2011",2011,92.0,Horror,6.1,48125,2000000,0,2151887,-2000000,151887
693,Chronicle,"Feb 3, 2012",2012,84.0,"Drama,Sci-Fi,Thriller",7.1,229258,12000000,64575175,123681790,52575175,111681790
695,Joyful Noise,"Jan 13, 2012",2012,118.0,"Comedy,Drama,Music",5.8,7575,27500000,30932113,31157914,3432113,3657914
696,Office Christmas Party,"Dec 9, 2016",2016,105.0,Comedy,5.8,59253,45000000,54767494,91323299,9767494,46323299
697,Alex Cross,"Oct 19, 2012",2012,101.0,"Action,Crime,Mystery",5.1,30951,35000000,25888412,35426759,-9111588,426759
698,Triple 9,"Feb 26, 2016",2016,115.0,"Crime,Thriller",6.3,60369,20000000,12639297,25943792,-7360703,5943792
699,The Spectacular Now,"Aug 2, 2013",2013,95.0,"Comedy,Drama,Romance",7.1,133887,2500000,6852971,6916951,4352971,4416951
700,Weekend,"Sep 23, 2011",2011,97.0,"Drama,Romance",7.6,25424,190000,484592,1577585,294592,1387585
701,Weekend,"Sep 23, 2011",2011,121.0,"Action,Comedy,Crime",4.0,583,190000,484592,1577585,294592,1387585
704,We're the Millers,"Aug 7, 2013",2013,110.0,"Comedy,Crime",7.0,371759,37000000,150394119,267816276,113394119,230816276
705,Shame,"Dec 2, 2011",2011,101.0,Drama,7.2,171353,6500000,4002293,20412841,-2497707,13912841
706,The Way Way Back,"Jul 5, 2013",2013,103.0,"Comedy,Drama",7.4,132642,5000000,21502690,26853810,16502690,21853810
707,Scouts Guide to the Zombie Apocalypse,"Oct 30, 2015",2015,93.0,"Action,Comedy,Horror",6.3,40479,15000000,3703046,15554855,-11296954,554855
708,Bohemian Rhapsody,"Nov 2, 2018",2018,134.0,"Biography,Drama,Music",8.0,345466,55000000,216303339,894985342,161303339,839985342
711,The Family,"Sep 13, 2013",2013,111.0,"Comedy,Crime,Thriller",6.3,102576,30000000,36918811,51078541,6918811,21078541
712,The Family,"Sep 13, 2013",2013,152.0,"Comedy,Crime,Drama",7.5,15,30000000,36918811,51078541,6918811,21078541
714,Ender's Game,"Nov 1, 2013",2013,114.0,"Action,Adventure,Fantasy",6.6,211722,110000000,61737191,127983283,-48262809,17983283
716,Snow White and the Huntsman,"Jun 1, 2012",2012,127.0,"Action,Adventure,Drama",6.1,258938,170000000,155136755,401021746,-14863245,231021746
723,Secret in Their Eyes,"Nov 20, 2015",2015,111.0,"Crime,Drama,Mystery",6.3,37455,20000000,20180155,32608019,180155,12608019
724,Jersey Boys,"Jun 20, 2014",2014,134.0,"Biography,Drama,Music",6.8,30410,40000000,47047013,65282732,7047013,25282732
726,I Don't Know How She Does It,"Sep 16, 2011",2011,89.0,"Comedy,Romance",4.9,18552,24000000,9659074,24474463,-14340926,474463
727,Moonrise Kingdom,"May 25, 2012",2012,94.0,"Adventure,Comedy,Drama",7.8,291750,16000000,45512466,68848446,29512466,52848446
733,Like Crazy,"Oct 28, 2011",2011,86.0,"Drama,Romance",6.7,55841,250000,3395391,3728400,3145391,3478400
734,The To Do List,"Jul 26, 2013",2013,104.0,"Comedy,Romance",5.8,34524,1500000,3491669,4128828,1991669,2628828
735,The Snowman,"Oct 20, 2017",2017,119.0,"Crime,Drama,Mystery",5.1,47890,35000000,6670765,43226146,-28329235,8226146
736,Arbitrage,"Sep 14, 2012",2012,107.0,"Drama,Thriller",6.6,46774,12000000,7919574,35830713,-4080426,23830713
737,Killing Them Softly,"Nov 30, 2012",2012,97.0,"Crime,Thriller",6.2,124086,15000000,14945541,39238443,-54459,24238443
738,The Expendables 2,"Aug 17, 2012",2012,103.0,"Action,Adventure,Thriller",6.6,277584,100000000,85028192,311979256,-14971808,211979256
740,Apollo 18,"Sep 2, 2011",2011,86.0,"Horror,Mystery,Sci-Fi",5.2,51427,5000000,17686929,26517819,12686929,21517819
743,Nerve,"Jul 27, 2016",2016,96.0,"Action,Adventure,Crime",6.5,102782,20000000,38583626,70652284,18583626,50652284
745,Wreck-It Ralph,"Nov 2, 2012",2012,101.0,"Adventure,Animation,Comedy",7.7,344496,165000000,189412677,496511521,24412677,331511521
746,Paranormal Activity 3,"Oct 21, 2011",2011,83.0,"Horror,Mystery,Thriller",5.8,85689,5000000,104028807,207039844,99028807,202039844
747,Anna Karenina,"Nov 16, 2012",2012,129.0,"Drama,Romance",6.6,84668,49000000,12816367,71004627,-36183633,22004627
748,Burn,"Jul 20, 2012",2012,86.0,Documentary,7.5,663,225000,1109276,1109276,884276,884276
749,No Escape,"Aug 26, 2015",2015,103.0,"Action,Thriller",6.8,70222,5000000,27288872,42844516,22288872,37844516
750,Madea's Big Happy Family,"Apr 22, 2011",2011,106.0,"Comedy,Drama",4.7,6996,25000000,53345287,54160818,28345287,29160818
751,Pirates of the Caribbean: Dead Men Tell No Tales,"May 26, 2017",2017,129.0,"Action,Adventure,Fantasy",6.6,228592,230000000,172558876,788241137,-57441124,558241137
752,The Maze Runner,"Sep 19, 2014",2014,113.0,"Action,Mystery,Sci-Fi",6.8,387038,34000000,102427862,348319861,68427862,314319861
753,Zero Dark Thirty,"Dec 19, 2012",2012,157.0,"Drama,Thriller",7.4,251072,52500000,95720716,134612435,43220716,82112435
754,The Campaign,"Aug 10, 2012",2012,85.0,Comedy,6.1,118678,95000000,86907746,104907746,-8092254,9907746
757,Cirque du Soleil: Worlds Away,"Dec 21, 2012",2012,91.0,Fantasy,6.8,7643,25000000,12512862,28012862,-12487138,3012862
758,Southpaw,"Jul 24, 2015",2015,124.0,"Drama,Sport",7.4,199783,30000000,52421953,94156456,22421953,64156456
762,American Hustle,"Dec 13, 2013",2013,138.0,"Crime,Drama",7.2,418221,40000000,150117807,257878294,110117807,217878294
763,That Awkward Moment,"Jan 31, 2014",2014,94.0,"Comedy,Romance",6.2,92148,8000000,26068955,53068955,18068955,45068955
764,Step Up Revolution,"Jul 27, 2012",2012,99.0,"Drama,Music,Romance",6.5,51295,33000000,35074677,165552290,2074677,132552290
767,Mama,"Jan 18, 2013",2013,100.0,"Horror,Thriller",6.2,158487,15000000,71628180,148095566,56628180,133095566
771,Son of God,"Feb 28, 2014",2014,138.0,"Biography,Drama,History",5.8,17606,22000000,59700064,70949793,37700064,48949793
772,Unbroken,"Dec 25, 2014",2014,137.0,"Biography,Drama,Sport",7.2,129981,65000000,115637895,163527824,50637895,98527824
773,Admission,"Mar 22, 2013",2013,107.0,"Comedy,Drama,Romance",5.7,31849,13000000,18007317,18733666,5007317,5733666
774,After Earth,"May 31, 2013",2013,100.0,"Action,Adventure,Drama",4.8,181687,130000000,60522097,251499665,-69477903,121499665
776,Nebraska,"Nov 15, 2013",2013,115.0,"Adventure,Comedy,Drama",7.7,105304,12000000,17654912,24761360,5654912,12761360
777,The Nut Job,"Jan 17, 2014",2014,85.0,"Adventure,Animation,Comedy",5.7,24587,30000000,64251538,122529966,34251538,92529966
781,RED 2,"Jul 19, 2013",2013,116.0,"Action,Comedy,Crime",6.6,148846,84000000,53262560,141507355,-30737440,57507355
782,Annie,"Dec 19, 2014",2014,118.0,"Comedy,Drama,Family",5.3,31241,65000000,85911262,139829625,20911262,74829625
783,Chappie,"Mar 6, 2015",2015,120.0,"Action,Crime,Drama",6.8,213733,49000000,31569268,105002056,-17430732,56002056
784,Black Panther,"Feb 16, 2018",2018,134.0,"Action,Adventure,Sci-Fi",7.3,516148,200000000,700059566,1348258224,500059566,1148258224
787,About Last Night,"Feb 14, 2014",2014,100.0,"Comedy,Romance",6.1,21078,13000000,48637684,50445860,35637684,37445860
789,Life of the Party,"May 11, 2018",2018,105.0,Comedy,5.5,25756,30000000,53059911,65759911,23059911,35759911
791,The Gambler,"Dec 10, 2014",2014,111.0,"Crime,Drama,Thriller",6.0,59995,25000000,33680992,38718031,8680992,13718031
794,A Separation,"Dec 30, 2011",2011,123.0,"Drama,Thriller",8.3,197684,800000,7098492,24426169,6298492,23626169
798,Truth or Dare,"Apr 13, 2018",2018,100.0,"Horror,Thriller",5.2,33621,3500000,41411015,95127344,37911015,91627344
799,Divergent,"Mar 21, 2014",2014,139.0,"Action,Adventure,Mystery",6.7,399703,85000000,150947895,276014965,65947895,191014965
800,The Words,"Sep 7, 2012",2012,102.0,"Drama,Mystery,Romance",7.1,70308,6000000,11494838,16369708,5494838,10369708
803,Captain America: The Winter Soldier,"Apr 4, 2014",2014,136.0,"Action,Adventure,Sci-Fi",7.8,666252,170000000,259746958,714401889,89746958,544401889
811,Sisters,"Dec 18, 2015",2015,118.0,Comedy,6.0,58994,30000000,87044645,106030660,57044645,76030660
813,Django Unchained,"Dec 25, 2012",2012,165.0,"Drama,Western",8.4,1211405,100000000,162805434,449948323,62805434,349948323
815,Percy Jackson: Sea of Monsters,"Aug 7, 2013",2013,106.0,"Adventure,Family,Fantasy",5.8,102313,90000000,68559554,200859554,-21440446,110859554
816,End of Watch,"Sep 21, 2012",2012,109.0,"Action,Crime,Drama",7.6,211308,15000000,41003371,57586606,26003371,42586606
817,Resident Evil: Retribution,"Sep 14, 2012",2012,95.0,"Action,Horror,Sci-Fi",5.4,125191,65000000,42345531,240647629,-22654469,175647629
818,Blade Runner 2049,"Oct 6, 2017",2017,164.0,"Drama,Mystery,Sci-Fi",8.0,376241,185000000,92054159,259357408,-92945841,74357408
819,To Rome with Love,"Jun 22, 2012",2012,112.0,"Comedy,Music,Romance",6.3,79381,21500000,16684352,74326015,-4815648,52826015
820,Dirty Grandpa,"Jan 22, 2016",2016,102.0,Comedy,5.9,101393,11500000,35593113,105078449,24093113,93578449
821,Turbo,"Jul 17, 2013",2013,96.0,"Adventure,Animation,Comedy",6.4,74639,135000000,83028130,286896578,-51971870,151896578
822,Safety Not Guaranteed,"Jun 8, 2012",2012,86.0,"Comedy,Drama,Romance",7.0,111907,750000,4010957,4422318,3260957,3672318
823,The Sessions,"Oct 19, 2012",2012,95.0,"Biography,Comedy,Drama",7.2,39731,1000000,6002451,11495204,5002451,10495204
825,Race,"Feb 19, 2016",2016,134.0,"Biography,Drama,Sport",7.1,30777,5000000,19115191,23745772,14115191,18745772
829,Life,"Mar 24, 2017",2017,104.0,"Horror,Sci-Fi,Thriller",6.6,182840,58000000,30234022,100929666,-27765978,42929666
832,The Amazing Spider-Man 2,"May 2, 2014",2014,142.0,"Action,Adventure,Sci-Fi",6.6,388363,200000000,202853933,708996336,2853933,508996336
833,The Judge,"Oct 10, 2014",2014,141.0,"Crime,Drama",7.4,162952,50000000,47119388,76119388,-2880612,26119388
835,Sparkle,"Aug 17, 2012",2012,116.0,"Drama,Music",5.7,5643,10000000,24397469,24660323,14397469,14660323
836,X-Men: Days of Future Past,"May 23, 2014",2014,132.0,"Action,Adventure,Sci-Fi",8.0,620079,200000000,233921534,747862775,33921534,547862775
837,The Darkness,"May 13, 2016",2016,92.0,"Horror,Thriller",4.4,12435,4000000,10753574,10898293,6753574,6898293
838,The Edge of Seventeen,"Nov 18, 2016",2016,104.0,"Comedy,Drama",7.3,87602,9000000,14431633,19096003,5431633,10096003
841,Spotlight,"Nov 6, 2015",2015,129.0,"Crime,Drama",8.1,365110,20000000,45055776,92088460,25055776,72088460
842,Spotlight,"Nov 6, 2015",2015,99.0,Drama,8.0,12,20000000,45055776,92088460,25055776,72088460
844,Parker,"Jan 25, 2013",2013,118.0,"Action,Crime,Thriller",6.2,105529,35000000,17616641,48543388,-17383359,13543388
845,Flight,"Nov 2, 2012",2012,138.0,"Drama,Thriller",7.3,303009,31000000,93772375,160558438,62772375,129558438
847,Miss Bala,"Feb 1, 2019",2019,104.0,"Action,Crime,Drama",5.5,3738,15000000,14998027,15362298,-1973,362298
848,The Call,"Mar 15, 2013",2013,94.0,"Crime,Drama,Horror",6.7,103780,12800000,51872378,69821476,39072378,57021476
850,Penguins of Madagascar,"Nov 26, 2014",2014,92.0,"Adventure,Animation,Comedy",6.7,72551,132000000,83350911,366942531,-48649089,234942531
851,Magic Mike,"Jun 29, 2012",2012,110.0,"Comedy,Drama",6.1,123955,7000000,113721571,170549753,106721571,163549753
852,Bachelorette,"Sep 7, 2012",2012,87.0,"Comedy,Romance",5.3,43131,3000000,446770,12577401,-2553230,9577401
853,Pompeii,"Feb 21, 2014",2014,105.0,"Action,Adventure,Drama",5.5,100467,80000000,23169033,108469033,-56830967,28469033
854,Glee: The 3D Concert Movie,"Aug 12, 2011",2011,84.0,"Documentary,Music",5.4,5449,9000000,11862398,17462398,2862398,8462398
855,Sinister,"Oct 12, 2012",2012,110.0,"Horror,Mystery,Thriller",6.8,198345,3000000,48086903,87727807,45086903,84727807
856,The Big Wedding,"Apr 26, 2013",2013,89.0,"Comedy,Drama,Romance",5.6,44221,32500000,21819348,48425971,-10680652,15925971
857,Seven Psychopaths,"Oct 12, 2012",2012,110.0,"Comedy,Crime",7.2,223493,13500000,15024049,33035736,1524049,19535736
859,Carrie,"Oct 18, 2013",2013,100.0,"Drama,Horror",5.9,125424,30000000,35266619,82409520,5266619,52409520
863,Exeter,"Sep 1, 2015",2015,91.0,"Horror,Mystery,Thriller",4.5,5156,25000,0,489792,-25000,464792
865,The Hunger Games: Catching Fire,"Nov 22, 2013",2013,146.0,"Action,Adventure,Sci-Fi",7.5,575455,130000000,424668047,864868047,294668047,734868047
866,The Hunger Games: Mockingjay - Part 1,"Nov 21, 2014",2014,123.0,"Action,Adventure,Sci-Fi",6.6,379050,125000000,337135885,766575131,212135885,641575131
867,The Hunger Games: Mockingjay - Part 2,"Nov 20, 2015",2015,137.0,"Action,Adventure,Sci-Fi",6.6,252384,160000000,281723902,648986787,121723902,488986787
868,Sex Tape,"Jul 18, 2014",2014,94.0,"Comedy,Romance",5.1,100520,40000000,38543473,126069509,-1456527,86069509
869,American Assassin,"Sep 15, 2017",2017,112.0,"Action,Thriller",6.2,57793,63000000,36249674,68310140,-26750326,5310140
870,Tomorrowland,"May 22, 2015",2015,130.0,"Action,Adventure,Family",6.4,161343,170000000,93436322,206627518,-76563678,36627518
878,Tag,"Jun 15, 2018",2018,100.0,Comedy,6.5,85186,28000000,54730625,77026186,26730625,49026186
879,Compliance,"Aug 17, 2012",2012,90.0,"Biography,Crime,Drama",6.4,28703,270000,319285,830700,49285,560700
880,A Most Wanted Man,"Jul 25, 2014",2014,122.0,"Crime,Drama,Thriller",6.8,67914,15000000,17237855,36068890,2237855,21068890
881,The Best of Me,"Oct 17, 2014",2014,118.0,"Drama,Romance",6.7,59750,26000000,26766213,41059418,766213,15059418
882,Sholem Aleichem: Laughing in the Darkness,"Jul 8, 2011",2011,93.0,Documentary,6.8,157,500000,1131261,1131261,631261,631261
883,Rush,"Sep 20, 2013",2013,123.0,"Action,Biography,Drama",8.1,393437,38000000,26947624,98230839,-11052376,60230839
886,The Good Dinosaur,"Nov 25, 2015",2015,93.0,"Adventure,Animation,Comedy",6.7,91465,187500000,123087120,333771037,-64412880,146271037
887,Pain & Gain,"Apr 26, 2013",2013,129.0,"Action,Comedy,Crime",6.4,187820,26000000,49875291,81275291,23875291,55275291
888,Thor: The Dark World,"Nov 8, 2013",2013,112.0,"Action,Adventure,Fantasy",6.9,540996,150000000,206362140,644602516,56362140,494602516
889,Geostorm,"Oct 20, 2017",2017,109.0,"Action,Sci-Fi,Thriller",5.3,78287,100000000,33700160,220796009,-66299840,120796009
890,Pitch Perfect,"Sep 28, 2012",2012,112.0,"Comedy,Music,Romance",7.2,256565,17000000,65001093,116044347,48001093,99044347
891,Cloudy with a Chance of Meatballs 2,"Sep 27, 2013",2013,95.0,"Adventure,Animation,Comedy",6.4,81010,78000000,119793567,274392649,41793567,196392649
893,Robot & Frank,"Aug 17, 2012",2012,89.0,"Comedy,Crime,Drama",7.1,59229,2500000,3317468,4934356,817468,2434356
894,Chernobyl Diaries,"May 25, 2012",2012,86.0,"Horror,Mystery,Thriller",5.0,60304,1000000,18119640,42411721,17119640,41411721
895,Kevin Hart: Laugh at My Pain,"Sep 9, 2011",2011,89.0,"Comedy,Documentary",7.4,5081,750000,7706436,7712436,6956436,6962436
896,Hell Fest,"Sep 28, 2018",2018,89.0,Horror,5.5,8662,5500000,11107431,18119231,5607431,12619231
897,Neighbors,"May 9, 2014",2014,97.0,Comedy,6.3,266020,18000000,150086800,270944428,132086800,252944428
899,War Dogs,"Aug 19, 2016",2016,114.0,"Comedy,Crime,Drama",7.1,154029,50000000,43034523,86234503,-6965477,36234503
902,The 33,"Nov 13, 2015",2015,127.0,"Biography,Drama,History",6.9,32263,25000000,12227722,28400715,-12772278,3400715
903,No Good Deed,"Sep 12, 2014",2014,84.0,"Action,Crime,Drama",5.6,16045,13200000,52543632,54323210,39343632,41123210
904,Guardians of the Galaxy,"Aug 1, 2014",2014,121.0,"Action,Adventure,Comedy",8.1,948394,170000000,333172112,770867516,163172112,600867516
905,The Smurfs 2,"Jul 31, 2013",2013,105.0,"Adventure,Animation,Comedy",5.4,34229,110000000,71017784,348547523,-38982216,238547523
906,Diary of a Wimpy Kid: Dog Days,"Aug 3, 2012",2012,94.0,"Comedy,Family",6.3,19571,22000000,49008662,77229695,27008662,55229695
907,Identity Thief,"Feb 8, 2013",2013,111.0,"Adventure,Comedy,Crime",5.7,115624,35000000,134506920,175361578,99506920,140361578
908,Non-Stop,"Feb 28, 2014",2014,106.0,"Action,Mystery,Thriller",7.0,234717,50000000,91742160,222383055,41742160,172383055
909,12 Years a Slave,"Oct 18, 2013",2013,134.0,"Biography,Drama,History",8.1,577301,20000000,56671993,181025343,36671993,161025343
911,The Last Exorcism Part II,"Mar 1, 2013",2013,88.0,"Drama,Horror,Thriller",4.0,15124,4000000,15179303,25448707,11179303,21448707
913,The Great Wall,"Feb 17, 2017",2017,72.0,Documentary,6.5,24,150000000,45157105,334486852,-104842895,184486852
915,Flatliners,"Sep 29, 2017",2017,109.0,"Drama,Horror,Mystery",5.2,33752,20000000,16883115,45173738,-3116885,25173738
916,Inside Llewyn Davis,"Dec 6, 2013",2013,104.0,"Drama,Music",7.5,123759,11000000,13248209,32943247,2248209,21943247
920,Side Effects,"Feb 8, 2013",2013,106.0,"Crime,Drama,Mystery",7.1,168466,30000000,32172757,66742138,2172757,36742138
923,Point Break,"Dec 25, 2015",2015,114.0,"Action,Crime,Sport",5.3,53802,100000000,28782481,126704591,-71217519,26704591
928,Rocketman,"May 31, 2019",2019,121.0,"Biography,Drama,Music",7.7,24266,41000000,57342725,108642725,16342725,67642725
933,The Mule,"Dec 14, 2018",2018,116.0,"Crime,Drama,Thriller",7.1,58955,50000000,103804407,170857676,53804407,120857676
934,Holy Motors,"Oct 17, 2012",2012,115.0,"Drama,Fantasy",7.1,36874,4000000,641054,4230426,-3358946,230426
935,Steve Jobs,"Oct 9, 2015",2015,122.0,"Biography,Drama",7.2,138668,30000000,17766658,35579007,-12233342,5579007
936,The Best Man Holiday,"Nov 15, 2013",2013,123.0,"Comedy,Drama",6.7,13967,17000000,70525195,72835710,53525195,55835710
937,The Imitation Game,"Nov 28, 2014",2014,114.0,"Biography,Drama,Thriller",8.0,620834,15000000,91125143,227740463,76125143,212740463
938,Captain Underpants: The First Epic Movie,"Jun 2, 2017",2017,89.0,"Action,Animation,Comedy",6.2,21903,38000000,73921000,126577874,35921000,88577874
939,Dumb and Dumber To,"Nov 14, 2014",2014,109.0,"Adventure,Comedy",5.6,118646,40000000,86208010,156553592,46208010,116553592
940,"McFarland, USA","Feb 20, 2015",2015,129.0,"Biography,Drama,Sport",7.4,31735,17000000,44480275,45707924,27480275,28707924
943,Tammy,"Jul 2, 2014",2014,97.0,"Comedy,Romance",4.9,44345,20000000,84525432,96407655,64525432,76407655
944,Dawn of the Planet of the Apes,"Jul 11, 2014",2014,130.0,"Action,Adventure,Drama",7.6,390199,170000000,208545589,710644566,38545589,540644566
945,Into the Storm,"Aug 8, 2014",2014,89.0,"Action,Adventure,Drama",5.8,60894,50000000,47602194,150429371,-2397806,100429371
947,Paranormal Activity 4,"Oct 19, 2012",2012,88.0,"Horror,Mystery,Thriller",4.6,58408,5000000,53900335,142817992,48900335,137817992
948,Transformers: Age of Extinction,"Jun 27, 2014",2014,165.0,"Action,Adventure,Sci-Fi",5.7,283486,210000000,245439076,1104039076,35439076,894039076
949,Hacksaw Ridge,"Nov 4, 2016",2016,139.0,"Biography,Drama,History",8.1,366904,40000000,67209615,168904682,27209615,128904682
950,Pixels,"Jul 24, 2015",2015,105.0,"Action,Comedy,Sci-Fi",5.6,119789,90000000,78765986,244041804,-11234014,154041804
953,Alpha,"Aug 17, 2018",2018,96.0,"Adventure,Drama,Family",6.7,41882,51000000,35851379,99624873,-15148621,48624873
955,Home Again,"Sep 8, 2017",2017,97.0,"Comedy,Drama,Romance",5.8,22614,15000000,27020284,37336874,12020284,22336874
956,Beasts of the Southern Wild,"Jun 27, 2012",2012,93.0,"Adventure,Drama,Fantasy",7.3,77440,1800000,12795746,23265132,10995746,21465132
957,San Andreas,"May 29, 2015",2015,114.0,"Action,Adventure,Drama",6.1,192750,110000000,155190832,456258539,45190832,346258539
958,Second Act,"Dec 21, 2018",2018,103.0,"Comedy,Drama,Romance",5.8,13109,15700000,39282227,63288854,23582227,47588854
959,Long Shot,"May 3, 2019",2019,125.0,"Comedy,Romance",7.2,12814,40000000,30202860,43711031,-9797140,3711031
960,Saving Mr. Banks,"Dec 13, 2013",2013,125.0,"Biography,Comedy,Drama",7.5,140678,35000000,83299761,114962525,48299761,79962525
961,The Accountant,"Oct 14, 2016",2016,128.0,"Action,Crime,Drama",7.3,233022,40000000,86260045,152962083,46260045,112962083
963,The Walk,"Sep 30, 2015",2015,89.0,"Crime,Thriller",6.8,126,35000000,10161183,61492104,-24838817,26492104
964,The Walk,"Sep 30, 2015",2015,123.0,"Adventure,Biography,Drama",7.3,109714,35000000,10161183,61492104,-24838817,26492104
965,Khiladi 786,"Dec 7, 2012",2012,141.0,"Action,Comedy",4.4,5648,5600000,385422,14683763,-5214578,9083763
966,Horrible Bosses 2,"Nov 26, 2014",2014,108.0,"Comedy,Crime",6.3,144442,40000000,54445357,105945357,14445357,65945357
967,St. Vincent,"Oct 10, 2014",2014,102.0,"Comedy,Drama",7.3,89372,13000000,44137712,54837234,31137712,41837234
968,3 Days to Kill,"Feb 21, 2014",2014,117.0,"Action,Drama,Thriller",6.2,81681,28000000,30697999,38959900,2697999,10959900
970,The Monuments Men,"Feb 7, 2014",2014,118.0,"Comedy,Drama,History",6.1,117638,70000000,78031620,158702748,8031620,88702748
971,Yeh Jawaani Hai Deewani,"May 31, 2013",2013,160.0,"Comedy,Drama,Musical",7.1,33971,8300000,3827466,50827466,-4472534,42527466
972,American Sniper,"Dec 25, 2014",2014,133.0,"Action,Biography,Drama",7.3,401915,58000000,350126372,547326372,292126372,489326372
973,Into the Woods,"Dec 25, 2014",2014,125.0,"Adventure,Comedy,Drama",6.0,123577,56200000,128002372,213116401,71802372,156916401
980,Earth to Echo,"Jul 2, 2014",2014,91.0,"Adventure,Family,Sci-Fi",5.8,17627,13000000,38934842,42174545,25934842,29174545
981,The Purge,"Jun 7, 2013",2013,85.0,"Horror,Thriller",5.7,183549,3000000,64473115,91266581,61473115,88266581
982,Grown Ups 2,"Jul 12, 2013",2013,101.0,Comedy,5.4,128500,80000000,133668525,247023808,53668525,167023808
983,The Counselor,"Oct 25, 2013",2013,117.0,"Crime,Drama,Thriller",5.3,92096,25000000,16973715,71009334,-8026285,46009334
984,About Time,"Nov 1, 2013",2013,123.0,"Comedy,Drama,Fantasy",7.8,263136,12000000,15323921,89309178,3323921,77309178
985,Run All Night,"Mar 13, 2015",2015,114.0,"Action,Drama,Thriller",6.6,94131,50000000,26461644,66961644,-23538356,16961644
987,Transcendence,"Apr 18, 2014",2014,119.0,"Action,Drama,Sci-Fi",6.3,204481,100000000,23022309,103039258,-76977691,3039258
988,The Other Woman,"Apr 25, 2014",2014,109.0,"Comedy,Romance",6.0,122889,40000000,83911193,195111193,43911193,155111193
989,Addicted,"Oct 10, 2014",2014,106.0,"Drama,Thriller",5.2,7640,5000000,17390770,17499242,12390770,12499242
990,Before Midnight,"May 24, 2013",2013,109.0,"Drama,Romance",7.9,123107,3000000,8110621,23251930,5110621,20251930
991,Katy Perry: Part of Me,"Jul 5, 2012",2012,93.0,"Documentary,Music",5.9,13034,12000000,25326071,32700439,13326071,20700439
993,Draft Day,"Apr 11, 2014",2014,110.0,"Drama,Sport",6.8,48812,25000000,28842237,29847480,3842237,4847480
994,Home,"Mar 27, 2015",2015,94.0,"Adventure,Animation,Comedy",6.6,85831,130000000,177397510,385997896,47397510,255997896
1006,The Jungle Book,"Apr 15, 2016",2016,106.0,"Adventure,Drama,Family",7.4,240821,175000000,364001123,962854547,189001123,787854547
1008,Don Jon,"Sep 27, 2013",2013,90.0,"Comedy,Drama,Romance",6.6,216350,5500000,24477704,41268579,18977704,35768579
1009,Rampage,"Apr 13, 2018",2018,107.0,"Action,Adventure,Sci-Fi",6.1,115891,120000000,101028233,428056280,-18971767,308056280
1010,The Internship,"Jun 7, 2013",2013,119.0,Comedy,6.3,179817,58000000,44672764,93672764,-13327236,35672764
1011,Dear White People,"Oct 17, 2014",2014,108.0,"Comedy,Drama,Romance",6.1,23321,1250000,4404154,5403771,3154154,4153771
1013,Valerian and the City of a Thousand Planets,"Jul 21, 2017",2017,137.0,"Action,Adventure,Fantasy",6.5,139792,180000000,40479370,215098356,-139520630,35098356
1014,Think Like a Man Too,"Jun 20, 2014",2014,106.0,"Comedy,Romance",5.8,18533,24000000,65028687,70027933,41028687,46027933
1015,Money Monster,"May 13, 2016",2016,98.0,"Crime,Drama,Thriller",6.5,86607,27000000,41012075,93466095,14012075,66466095
1017,Left Behind,"Oct 3, 2014",2014,110.0,"Action,Drama,Fantasy",3.1,33515,16000000,14019924,20769209,-1980076,4769209
1018,A Haunted House,"Jan 11, 2013",2013,86.0,"Comedy,Fantasy",5.1,40308,2500000,40041683,59922558,37541683,57422558
1020,Big Hero 6,"Nov 7, 2014",2014,102.0,"Action,Adventure,Animation",7.8,371204,165000000,222527828,652127828,57527828,487127828
1021,When the Game Stands Tall,"Aug 22, 2014",2014,115.0,"Drama,Family,Sport",6.7,14498,15000000,30127963,30138912,15127963,15138912
1022,Spider-Man: Homecoming,"Jul 7, 2017",2017,133.0,"Action,Adventure,Sci-Fi",7.5,426302,175000000,334201140,880166350,159201140,705166350
1029,The Book of Life,"Oct 17, 2014",2014,95.0,"Adventure,Animation,Comedy",7.3,59486,50000000,50151543,97651543,151543,47651543
1031,Kung Fu Panda 3,"Jan 29, 2016",2016,95.0,"Action,Adventure,Animation",7.1,116166,140000000,143528619,517599142,3528619,377599142
1032,Gone Girl,"Oct 3, 2014",2014,149.0,"Drama,Mystery,Thriller",8.1,761592,61000000,167767189,368567189,106767189,307567189
1033,Magic Mike XXL,"Jul 1, 2015",2015,115.0,"Comedy,Drama,Music",5.6,48497,14500000,66013057,123660597,51513057,109160597
1038,Finding Dory,"Jun 17, 2016",2016,97.0,"Adventure,Animation,Comedy",7.3,213542,200000000,486295561,1021215193,286295561,821215193
1039,The Grand Budapest Hotel,"Mar 7, 2014",2014,99.0,"Adventure,Comedy,Crime",8.1,633604,31000000,59076019,163981261,28076019,132981261
1040,Love the Coopers,"Nov 13, 2015",2015,107.0,"Comedy,Fantasy,Romance",5.8,18018,18000000,26302731,42227490,8302731,24227490
1041,The SpongeBob Movie: Sponge Out of Water,"Feb 6, 2015",2015,92.0,"Adventure,Animation,Comedy",6.0,43560,74000000,162994032,311013181,88994032,237013181
1042,Muppets Most Wanted,"Mar 21, 2014",2014,107.0,"Adventure,Comedy,Crime",6.4,29018,55000000,51178893,79312301,-3821107,24312301
1043,Jumanji: Welcome to the Jungle,"Dec 20, 2017",2017,119.0,"Action,Adventure,Comedy",7.0,242735,90000000,404508916,964496193,314508916,874496193
1046,Minions,"Jul 10, 2015",2015,91.0,"Adventure,Animation,Comedy",6.4,193917,74000000,336045770,1160336173,262045770,1086336173
1047,22 Jump Street,"Jun 13, 2014",2014,112.0,"Action,Comedy,Crime",7.0,319504,50000000,191719337,331333876,141719337,281333876
1049,Concussion,"Dec 25, 2015",2015,123.0,"Biography,Drama,Sport",7.1,77576,35000000,34531832,50363790,-468168,15363790
1050,Sherlock Gnomes,"Mar 23, 2018",2018,86.0,"Adventure,Animation,Comedy",5.1,8030,59000000,43242871,87527651,-15757129,28527651
1051,Olympus Has Fallen,"Mar 22, 2013",2013,119.0,"Action,Thriller",6.5,235443,70000000,98927592,172878928,28927592,102878928
1053,The 5th Wave,"Jan 22, 2016",2016,112.0,"Action,Adventure,Drama",5.2,90788,38000000,34912982,111336398,-3087018,73336398
1054,Wild,"Dec 3, 2014",2014,115.0,"Adventure,Biography,Drama",7.1,110138,15000000,37880356,52460543,22880356,37460543
1057,The Gallows,"Jul 10, 2015",2015,81.0,"Horror,Mystery,Thriller",4.2,17763,100000,22764410,41656474,22664410,41556474
1059,The Hobbit: The Battle of the Five Armies,"Dec 17, 2014",2014,144.0,"Adventure,Fantasy",7.4,438621,250000000,255119788,945577621,5119788,695577621
1060,Homefront,"Nov 27, 2013",2013,100.0,"Action,Thriller",6.5,98549,22000000,20158492,51695362,-1841508,29695362
1061,Alien: Covenant,"May 19, 2017",2017,122.0,"Horror,Sci-Fi,Thriller",6.4,226920,97000000,74262031,238521247,-22737969,141521247
1063,Endless Love,"Feb 14, 2014",2014,104.0,"Drama,Romance",6.3,37869,20000000,23438250,34718173,3438250,14718173
1064,ABCD (Any Body Can Dance),"Feb 8, 2013",2013,160.0,"Drama,Music",6.4,5695,1900000,222098,10137234,-1677902,8237234
1065,The Babadook,"Nov 28, 2014",2014,94.0,"Drama,Horror",6.8,171411,2000000,950792,7482387,-1049208,5482387
1066,Fifty Shades of Grey,"Feb 13, 2015",2015,125.0,"Drama,Romance,Thriller",4.1,279126,40000000,166167230,570998101,126167230,530998101
1067,The Expendables 3,"Aug 15, 2014",2014,126.0,"Action,Adventure,Thriller",6.1,156432,100000000,39322544,209461378,-60677456,109461378
1068,Fruitvale Station,"Jul 12, 2013",2013,85.0,"Biography,Drama,Romance",7.5,68187,900000,16098998,17549645,15198998,16649645
1069,Blue Jasmine,"Jul 26, 2013",2013,98.0,Drama,7.3,179453,18000000,33404871,102912961,15404871,84912961
1070,White House Down,"Jun 28, 2013",2013,131.0,"Action,Drama,Thriller",6.4,191791,150000000,73103784,205440387,-76896216,55440387
1072,The Mummy,"Jun 9, 2017",2017,110.0,"Action,Adventure,Fantasy",5.5,154345,195000000,80101125,409953905,-114898875,214953905
1075,Grace Unplugged,"Oct 4, 2013",2013,102.0,"Drama,Music",6.2,3006,1700000,2507159,2507159,807159,807159
1076,Jobs,"Aug 16, 2013",2013,128.0,"Biography,Drama",5.9,88788,18000000,16131410,43402515,-1868590,25402515
1077,Rio 2,"Apr 11, 2014",2014,101.0,"Adventure,Animation,Comedy",6.3,72209,130000000,131538435,492846291,1538435,362846291
1078,The Great Beauty,"Nov 15, 2013",2013,141.0,Drama,7.8,72297,12000000,2883879,29549145,-9116121,17549145
1080,The Intern,"Sep 25, 2015",2015,121.0,"Comedy,Drama",7.1,191494,40000000,75764672,197115710,35764672,157115710
1081,Runner Runner,"Oct 4, 2013",2013,88.0,"Crime,Thriller",5.6,58235,30000000,19316646,60512680,-10683354,30512680
1083,Need for Speed,"Mar 14, 2014",2014,132.0,"Action,Crime,Thriller",6.5,154909,66000000,43568507,194169619,-22431493,128169619
1085,Deliver Us from Evil,"Jul 2, 2014",2014,118.0,"Horror,Mystery,Thriller",6.2,63793,30000000,30577122,87956618,577122,57956618
1086,Spectre,"Nov 6, 2015",2015,148.0,"Action,Adventure,Thriller",6.8,352504,300000000,200074175,879620923,-99925825,579620923
1087,Coco,"Nov 22, 2017",2017,105.0,"Adventure,Animation,Comedy",8.4,277194,175000000,209726015,798008101,34726015,623008101
1088,Coco,"Nov 22, 2017",2017,98.0,Horror,7.4,35,175000000,209726015,798008101,34726015,623008101
1089,Focus,"Feb 27, 2015",2015,105.0,"Comedy,Crime,Drama",6.6,192147,65000000,53862963,168065700,-11137037,103065700
1092,How to Train Your Dragon: The Hidden World,"Feb 22, 2019",2019,104.0,"Action,Adventure,Animation",7.6,60769,129000000,160791800,519258283,31791800,390258283
1093,Dark Skies,"Feb 22, 2013",2013,97.0,"Horror,Sci-Fi,Thriller",6.3,65754,3500000,17418667,27704111,13918667,24204111
1094,Delivery Man,"Nov 22, 2013",2013,105.0,"Comedy,Drama",6.4,70706,22000000,30659817,70536870,8659817,48536870
1096,The Girl on the Train,"Oct 7, 2016",2016,112.0,"Crime,Drama,Mystery",6.5,150977,45000000,75395035,174278214,30395035,129278214
1100,Max,"Jun 26, 2015",2015,111.0,"Adventure,Drama,Family",6.8,23976,20000000,42656255,43658157,22656255,23658157
1101,Enough Said,"Sep 18, 2013",2013,93.0,"Comedy,Drama,Romance",7.0,55698,8000000,17550872,25621449,9550872,17621449
1102,Avengers: Age of Ultron,"May 1, 2015",2015,141.0,"Action,Adventure,Sci-Fi",7.3,665594,330600000,459005868,1403013963,128405868,1072413963
1103,Smurfs: The Lost Village,"Apr 7, 2017",2017,90.0,"Adventure,Animation,Comedy",6.0,15612,60000000,45020282,197578586,-14979718,137578586
1104,The November Man,"Aug 27, 2014",2014,108.0,"Action,Crime,Thriller",6.3,59293,15000000,25018119,34820335,10018119,19820335
1105,Carol,"Nov 20, 2015",2015,118.0,"Drama,Romance",7.2,100680,11800000,12711491,42843521,911491,31043521
1109,Woman in Gold,"Apr 1, 2015",2015,109.0,"Biography,Drama,History",7.3,48501,11000000,33307793,58586407,22307793,47586407
1110,The Magnificent Seven,"Sep 23, 2016",2016,132.0,"Action,Adventure,Western",6.9,168514,90000000,93432655,162525156,3432655,72525156
1111,The Heat,"Jun 28, 2013",2013,117.0,"Action,Comedy,Crime",6.6,153501,43000000,159581587,229727774,116581587,186727774
1112,Atomic Blonde,"Jul 28, 2017",2017,115.0,"Action,Mystery,Thriller",6.7,150407,30000000,51573925,98345423,21573925,68345423
1113,Philomena,"Nov 22, 2013",2013,98.0,"Biography,Comedy,Drama",7.6,88704,12000000,37709979,98963392,25709979,86963392
1114,Project Almanac,"Jan 30, 2015",2015,106.0,"Drama,Mystery,Sci-Fi",6.4,71500,12000000,22348241,32909437,10348241,20909437
1116,The Boy,"Jan 22, 2016",2016,97.0,"Horror,Mystery,Thriller",6.0,68957,10000000,35819556,68220952,25819556,58220952
1118,The Peanuts Movie,"Nov 6, 2015",2015,88.0,"Adventure,Animation,Comedy",7.1,39149,99000000,130178411,250091610,31178411,151091610
1120,Paranormal Activity: The Ghost Dimension,"Oct 23, 2015",2015,88.0,"Horror,Mystery,Thriller",4.6,22361,10000000,18297124,77959374,8297124,67959374
1121,Get on Up,"Aug 1, 2014",2014,139.0,"Biography,Drama,Music",6.9,19024,30000000,30569935,33339868,569935,3339868
1122,Paranormal Activity: The Marked Ones,"Jan 3, 2014",2014,84.0,"Horror,Mystery,Thriller",5.0,37147,5000000,32462372,90904854,27462372,85904854
1123,Mr. Turner,"Dec 19, 2014",2014,150.0,"Biography,Drama,History",6.8,22661,14000000,3958546,25187026,-10041454,11187026
1127,Burnt,"Oct 30, 2015",2015,101.0,"Comedy,Drama",6.6,95988,20000000,13651946,36773510,-6348054,16773510
1128,Hotel Transylvania 2,"Sep 25, 2015",2015,89.0,"Animation,Comedy,Family",6.7,92905,80000000,169700110,469500298,89700110,389500298
1133,Blockers,"Apr 6, 2018",2018,102.0,Comedy,6.2,57142,21000000,60311495,94045328,39311495,73045328
1134,Arrival,"Nov 11, 2016",2016,116.0,"Drama,Mystery,Sci-Fi",7.9,515483,47000000,100546139,203127894,53546139,156127894
1135,Wonder,"Nov 17, 2017",2017,113.0,"Drama,Family",8.0,111632,20000000,132422809,304604712,112422809,284604712
1136,The Light Between Oceans,"Sep 2, 2016",2016,133.0,"Drama,Romance",7.2,46247,20000000,12545979,22281732,-7454021,2281732
1138,Crimson Peak,"Oct 16, 2015",2015,119.0,"Drama,Fantasy,Horror",6.5,119287,55000000,31090320,74966854,-23909680,19966854
1139,The Second Best Exotic Marigold Hotel,"Mar 6, 2015",2015,122.0,"Comedy,Drama",6.6,28931,10000000,33078266,90384306,23078266,80384306
1140,Pacific Rim: Uprising,"Mar 23, 2018",2018,111.0,"Action,Adventure,Sci-Fi",5.6,89462,155000000,59874525,290930148,-95125475,135930148
1141,Get Hard,"Mar 27, 2015",2015,100.0,"Comedy,Crime",6.0,111187,40000000,90411453,106511453,50411453,66511453
1142,Birdman or (The Unexpected Virtue of Ignorance),"Oct 17, 2014",2014,119.0,"Comedy,Drama",7.7,519417,18000000,42340598,103215094,24340598,85215094
1143,Alice Through the Looking Glass,"May 27, 2016",2016,113.0,"Adventure,Family,Fantasy",6.2,79951,170000000,77042381,276928112,-92957619,106928112
1144,Going in Style,"Apr 7, 2017",2017,96.0,"Comedy,Crime",6.6,66418,24000000,45018541,78672579,21018541,54672579
1145,Me and Earl and the Dying Girl,"Jun 12, 2015",2015,105.0,"Comedy,Drama,Romance",7.8,112627,8000000,6758416,9266180,-1241584,1266180
1146,Shut In,"Nov 11, 2016",2016,91.0,"Drama,Mystery,Thriller",4.7,11030,10000000,6900335,11360665,-3099665,1360665
1148,Hell or High Water,"Aug 12, 2016",2016,102.0,"Action,Crime,Drama",7.6,176469,12000000,27007844,37584304,15007844,25584304
1149,Whiplash,"Oct 10, 2014",2014,106.0,"Drama,Music",8.5,616916,3300000,13092006,38969037,9792006,35669037
1150,The Fault in Our Stars,"Jun 6, 2014",2014,126.0,"Drama,Romance",7.7,315135,12000000,124872350,307166834,112872350,295166834
1152,Kevin Hart: Let Me Explain,"Jul 3, 2013",2013,75.0,"Comedy,Documentary",6.8,7880,2500000,32244051,32327255,29744051,29827255
1155,Ted 2,"Jun 26, 2015",2015,115.0,Comedy,6.3,165843,68000000,81476385,217214143,13476385,149214143
1158,Sultan,"Jul 6, 2016",2016,170.0,"Action,Drama,Sport",7.1,33371,11000000,5599781,72989781,-5400219,61989781
1166,Star Trek Beyond,"Jul 22, 2016",2016,122.0,"Action,Adventure,Sci-Fi",7.1,209844,185000000,158848340,335802233,-26151660,150802233
1169,Youth,"Dec 4, 2015",2015,124.0,"Comedy,Drama,Music",7.3,64418,13000000,2703296,24001573,-10296704,11001573
1171,Fences,"Dec 16, 2016",2016,139.0,Drama,7.2,86749,24000000,57682904,64282881,33682904,40282881
1172,Me Before You,"Jun 3, 2016",2016,106.0,"Drama,Romance",7.4,174567,20000000,56245075,208265198,36245075,188265198
1173,Hitman: Agent 47,"Aug 21, 2015",2015,96.0,"Action,Adventure,Crime",5.7,80510,35000000,22467450,82182803,-12532550,47182803
1174,Night at the Museum: Secret of the Tomb,"Dec 19, 2014",2014,98.0,"Adventure,Comedy,Family",6.2,93103,127000000,113746621,353756621,-13253379,226756621
1176,The Boss,"Apr 8, 2016",2016,99.0,Comedy,5.4,39096,29000000,63077560,78652207,34077560,49652207
1177,All You Need Is Love,"Oct 31, 2014",2014,90.0,Documentary,6.8,9,300000,0,3565259,-300000,3265259
1179,Game Night,"Feb 23, 2018",2018,100.0,"Action,Comedy,Crime",7.0,163279,37000000,69179066,117378084,32179066,80378084
1180,The Secret Life of Pets,"Jul 8, 2016",2016,87.0,"Adventure,Animation,Comedy",6.5,161997,75000000,368384330,886750534,293384330,811750534
1181,Fury,"Oct 17, 2014",2014,134.0,"Action,Drama,War",7.6,381993,80000000,85817906,210315681,5817906,130315681
1183,Everest,"Sep 18, 2015",2015,121.0,"Action,Adventure,Biography",7.1,181133,65000000,43482270,221297061,-21517730,156297061
1185,The Longest Ride,"Apr 10, 2015",2015,123.0,"Drama,Romance",7.1,70327,34000000,37446117,63802928,3446117,29802928
1186,Devil's Due,"Jan 17, 2014",2014,89.0,"Horror,Mystery,Thriller",4.1,15502,7000000,15821461,36146087,8821461,29146087
1187,Sinister 2,"Aug 21, 2015",2015,97.0,"Horror,Mystery,Thriller",5.3,41782,10000000,27740955,54104225,17740955,44104225
1188,Beauty and the Beast,"Mar 17, 2017",2017,129.0,"Family,Fantasy,Musical",7.2,238325,160000000,504014165,1259199706,344014165,1099199706
1191,Top Five,"Dec 12, 2014",2014,102.0,"Comedy,Romance",6.4,24744,12000000,25317379,26001741,13317379,14001741
1193,The Circle,"Apr 28, 2017",2017,93.0,"Drama,Horror,Thriller",5.1,17,18000000,20497844,40651864,2497844,22651864
1194,The Circle,"Apr 28, 2017",2017,110.0,"Drama,Sci-Fi,Thriller",5.3,72536,18000000,20497844,40651864,2497844,22651864
1200,Mike and Dave Need Wedding Dates,"Jul 8, 2016",2016,98.0,"Adventure,Comedy,Romance",6.0,74849,33000000,46009673,75898100,13009673,42898100
1201,A Haunted House 2,"Apr 18, 2014",2014,86.0,"Comedy,Fantasy",4.7,18085,4000000,17329487,21206861,13329487,17206861
1202,Pitch Perfect 2,"May 15, 2015",2015,115.0,"Comedy,Music",6.4,130692,29000000,184296230,287625468,155296230,258625468
1204,Ride Along 2,"Jan 15, 2016",2016,102.0,"Action,Comedy,Crime",5.9,48688,40000000,90862685,124827316,50862685,84827316
1205,"As Above, So Below","Aug 29, 2014",2014,93.0,"Adventure,Horror,Mystery",6.2,66892,5000000,21222315,41824066,16222315,36824066
1206,Wish I Was Here,"Jul 18, 2014",2014,106.0,"Comedy,Drama",6.7,34907,6000000,3591299,6591365,-2408701,591365
1207,Nightcrawler,"Oct 31, 2014",2014,117.0,"Crime,Drama,Thriller",7.9,404476,8500000,32381218,50334418,23881218,41834418
1208,Lucy,"Jul 25, 2014",2014,89.0,"Action,Sci-Fi,Thriller",6.4,403194,40000000,126573960,457507776,86573960,417507776
1210,Red Sparrow,"Mar 2, 2018",2018,140.0,"Action,Drama,Thriller",6.6,136738,69000000,46874505,145951861,-22125495,76951861
1214,Obvious Child,"Jun 6, 2014",2014,84.0,"Comedy,Drama,Romance",6.8,21536,1000000,3122616,3324070,2122616,2324070
1217,John Wick,"Oct 24, 2014",2014,101.0,"Action,Crime,Thriller",7.4,449942,30000000,43037835,76235001,13037835,46235001
1218,The Lazarus Effect,"Feb 27, 2015",2015,83.0,"Horror,Mystery,Sci-Fi",5.2,37675,5000000,25801570,38359310,20801570,33359310
1220,The Transporter Refueled,"Sep 4, 2015",2015,96.0,"Action,Adventure,Crime",5.2,36201,22000000,16029670,69698495,-5970330,47698495
1221,Zootopia,"Mar 4, 2016",2016,108.0,"Adventure,Animation,Comedy",8.0,383446,150000000,341268248,1019429616,191268248,869429616
1223,Hot Pursuit,"May 8, 2015",2015,87.0,"Action,Comedy,Crime",5.1,44723,35000000,34580201,45671512,-419799,10671512
1224,Alvin and the Chipmunks: The Road Chip,"Dec 18, 2015",2015,92.0,"Adventure,Animation,Comedy",5.1,14507,90000000,85886987,249517956,-4113013,159517956
1225,The Purge: Anarchy,"Jul 18, 2014",2014,103.0,"Action,Horror,Sci-Fi",6.5,126203,9000000,71562550,111534881,62562550,102534881
1226,Batman v Superman: Dawn of Justice,"Mar 25, 2016",2016,151.0,"Action,Adventure,Fantasy",6.5,576909,250000000,330360194,867500281,80360194,617500281
1227,Dolphin Tale 2,"Sep 12, 2014",2014,107.0,"Drama,Family",6.4,7579,36000000,42024533,57824533,6024533,21824533
1228,The Theory of Everything,"Nov 7, 2014",2014,123.0,"Biography,Drama,Romance",7.7,361534,15000000,35893537,123327692,20893537,108327692
1229,The Hundred-Foot Journey,"Aug 8, 2014",2014,122.0,"Comedy,Drama",7.3,69562,22000000,54235441,94270488,32235441,72270488
1236,The Lego Ninjago Movie,"Sep 22, 2017",2017,101.0,"Action,Adventure,Animation",6.0,18926,70000000,59281555,122737201,-10718445,52737201
1237,Criminal,"Apr 15, 2016",2016,113.0,"Action,Crime,Drama",6.3,51666,31500000,14708696,38771262,-16791304,7271262
1241,Brothers,"Aug 14, 2015",2015,156.0,"Action,Drama,Sport",6.7,10689,13000000,656688,17856688,-12343312,4856688
1244,Inferno,"Oct 28, 2016",2016,121.0,"Action,Adventure,Crime",6.2,138978,75000000,34343574,219519367,-40656426,144519367
1247,Suffragette,"Oct 23, 2015",2015,106.0,"Biography,Drama,History",6.9,34306,14000000,4702420,34044909,-9297580,20044909
1251,Crazy Rich Asians,"Aug 15, 2018",2018,120.0,"Comedy,Romance",7.0,96617,30000000,174532921,238099711,144532921,208099711
1254,Now You See Me 2,"Jun 10, 2016",2016,129.0,"Action,Adventure,Comedy",6.5,216219,90000000,65075540,328325007,-24924460,238325007
1255,Beyond the Lights,"Nov 14, 2014",2014,116.0,"Drama,Music,Romance",6.9,14122,7000000,14618727,14618727,7618727,7618727
1256,Trainwreck,"Jul 17, 2015",2015,125.0,"Comedy,Drama,Romance",6.2,121860,35000000,110212700,141123897,75212700,106123897
1257,The Geographer Drank His Globe Away,"Dec 31, 2013",2013,120.0,"Adventure,Drama,Romance",7.4,3943,4000000,0,4454853,-4000000,454853
1258,Room,"Oct 16, 2015",2015,118.0,"Drama,Thriller",8.2,316791,13000000,14677674,36262783,1677674,23262783
1259,The Diary of a Teenage Girl,"Aug 7, 2015",2015,102.0,"Comedy,Drama,Romance",6.9,27003,2000000,1477002,2279959,-522998,279959
1260,The Boy Next Door,"Jan 23, 2015",2015,91.0,"Horror,Thriller",4.7,34816,4000000,36006065,53401938,32006065,49401938
1261,Fantastic Beasts and Where to Find Them,"Nov 18, 2016",2016,132.0,"Adventure,Family,Fantasy",7.3,365353,180000000,234037575,802402853,54037575,622402853
1263,Incarnate,"Dec 2, 2016",2016,91.0,"Horror,Thriller",5.3,10217,5000000,4799774,9371036,-200226,4371036
1264,The Blue Room,"Oct 3, 2014",2014,76.0,"Crime,Romance,Thriller",6.3,2855,1400000,260441,1945420,-1139559,545420
1272,Sully,"Sep 9, 2016",2016,96.0,"Biography,Drama",7.5,202718,60000000,125070033,238524556,65070033,178524556
1277,London Has Fallen,"Mar 4, 2016",2016,99.0,"Action,Thriller",5.9,124757,60000000,62524260,195194085,2524260,135194085
1278,American Ultra,"Aug 21, 2015",2015,96.0,"Action,Comedy,Sci-Fi",6.1,76769,28000000,14439985,30295028,-13560015,2295028
1282,Annabelle,"Oct 3, 2014",2014,99.0,"Horror,Mystery,Thriller",5.4,122039,6500000,84273813,256862920,77773813,250362920
1284,Pan,"Oct 9, 2015",2015,111.0,"Adventure,Comedy,Family",5.8,55867,150000000,35088320,151525973,-114911680,1525973
1285,Jigsaw,"Oct 27, 2017",2017,92.0,"Crime,Horror,Mystery",5.8,57184,10000000,38052832,102445196,28052832,92445196
1286,Compadres,"Apr 22, 2016",2016,101.0,"Action,Comedy,Crime",4.7,876,3000000,3127773,7445044,127773,4445044
1287,Transformers: The Last Knight,"Jun 21, 2017",2017,154.0,"Action,Adventure,Sci-Fi",5.2,119007,217000000,130168683,602893340,-86831317,385893340
1288,Gnome Alone,"Nov 20, 2015",2015,94.0,Horror,3.5,303,25000000,1872994,42425450,-23127006,17425450
1290,Legend,"Nov 20, 2015",2015,132.0,"Biography,Crime,Drama",7.0,138947,25000000,1872994,42425450,-23127006,17425450
1292,X-Men: Apocalypse,"May 27, 2016",2016,144.0,"Action,Adventure,Sci-Fi",7.0,356556,178000000,155442489,542537546,-22557511,364537546
1295,Jack Reacher: Never Go Back,"Oct 21, 2016",2016,118.0,"Action,Thriller",6.1,121892,60000000,58697076,159946489,-1302924,99946489
1296,Sicario,"Sep 18, 2015",2015,121.0,"Action,Crime,Drama",7.6,328548,30000000,46889293,84393749,16889293,54393749
1298,Oddball,"Dec 6, 2016",2016,5.0,Documentary,6.4,5,7000000,0,10237229,-7000000,3237229
1299,Fist Fight,"Feb 17, 2017",2017,91.0,Comedy,5.6,35136,25000000,32187017,40286416,7187017,15286416
1300,Murder on the Orient Express,"Nov 10, 2017",2017,114.0,"Crime,Drama,Mystery",6.5,178603,55000000,102826543,345922730,47826543,290922730
1301,Ferdinand,"Dec 15, 2017",2017,108.0,"Adventure,Animation,Comedy",6.7,40229,111000000,84410380,289847930,-26589620,178847930
1303,Ice Age: Collision Course,"Jul 22, 2016",2016,94.0,"Adventure,Animation,Comedy",5.7,48932,105000000,64063008,402156682,-40936992,297156682
1304,Paul Blart: Mall Cop 2,"Apr 17, 2015",2015,94.0,"Action,Comedy,Crime",4.4,30828,38000000,71091594,107650646,33091594,69650646
1305,War for the Planet of the Apes,"Jul 14, 2017",2017,140.0,"Action,Adventure,Drama",7.5,201943,152000000,146880162,489592267,-5119838,337592267
1308,The Hateful Eight,"Dec 25, 2015",2015,168.0,"Crime,Drama,Mystery",7.8,434966,62000000,54117416,147864886,-7882584,85864886
1310,Despicable Me 3,"Jun 30, 2017",2017,89.0,"Adventure,Animation,Comedy",6.3,92580,75000000,264624300,1034727750,189624300,959727750
1313,Sing,"Dec 21, 2016",2016,108.0,"Animation,Comedy,Family",7.1,115951,75000000,270329045,634454789,195329045,559454789
1315,Vice,"Dec 25, 2018",2018,132.0,"Biography,Comedy,Drama",7.2,72855,60000000,47836282,70883171,-12163718,10883171
1316,The Nut Job 2: Nutty by Nature,"Aug 11, 2017",2017,91.0,"Adventure,Animation,Comedy",5.5,4820,40000000,28370522,57438389,-11629478,17438389
1317,Captain America: Civil War,"May 6, 2016",2016,147.0,"Action,Adventure,Sci-Fi",7.8,583507,250000000,408084349,1140069413,158084349,890069413
1318,Thor: Ragnarok,"Nov 3, 2017",2017,130.0,"Action,Adventure,Comedy",7.9,482995,180000000,315058289,846980024,135058289,666980024
1321,The Disaster Artist,"Dec 1, 2017",2017,104.0,"Biography,Comedy,Drama",7.4,111737,10000000,21120616,28717667,11120616,18717667
1322,Moana,"Nov 23, 2016",2016,107.0,"Adventure,Animation,Comedy",7.6,224253,150000000,248757044,637517365,98757044,487517365
1323,Mechanic: Resurrection,"Aug 26, 2016",2016,98.0,"Action,Adventure,Thriller",5.7,67275,40000000,21218403,109738840,-18781597,69738840
1324,The Night Before,"Nov 20, 2015",2015,101.0,"Adventure,Comedy,Fantasy",6.4,58455,25000000,43035725,52427346,18035725,27427346
1326,American Made,"Sep 29, 2017",2017,115.0,"Action,Biography,Comedy",7.2,131043,50000000,51342000,135569212,1342000,85569212
1329,Girls Trip,"Jul 21, 2017",2017,122.0,"Comedy,Drama",6.2,29321,28000000,115108515,140886353,87108515,112886353
1331,The Other Side of the Door,"Mar 4, 2016",2016,96.0,Horror,5.3,15813,5000000,3000342,12905107,-1999658,7905107
1336,Knock Knock,"Oct 9, 2015",2015,99.0,"Drama,Thriller",4.9,68328,2000000,36336,6328516,-1963664,4328516
1338,Cars 3,"Jun 16, 2017",2017,102.0,"Adventure,Animation,Comedy",6.8,59408,175000000,152901115,383541369,-22098885,208541369
1339,Incredibles 2,"Jun 15, 2018",2018,118.0,"Action,Adventure,Animation",7.7,203510,200000000,608581744,1242520711,408581744,1042520711
1340,A Street Cat Named Bob,"Nov 18, 2016",2016,103.0,"Biography,Comedy,Drama",7.4,23204,8000000,82703,17382693,-7917297,9382693
1342,Paper Towns,"Jul 24, 2015",2015,109.0,"Comedy,Drama,Mystery",6.3,87742,12000000,32000304,85450484,20000304,73450484
1343,Ricki and the Flash,"Aug 7, 2015",2015,101.0,"Comedy,Drama,Music",5.9,20932,18000000,26839498,41166033,8839498,23166033
1344,Barbershop: The Next Cut,"Apr 15, 2016",2016,111.0,"Comedy,Drama",5.9,13306,20000000,54030051,54404202,34030051,34404202
1345,Allied,"Nov 23, 2016",2016,124.0,"Action,Drama,Romance",7.1,125741,106000000,40098064,119266661,-65901936,13266661
1346,The Martian,"Oct 2, 2015",2015,144.0,"Adventure,Drama,Sci-Fi",8.0,680116,108000000,228433663,655271443,120433663,547271443
1348,Dragon Blade,"Sep 4, 2015",2015,127.0,"Action,Adventure,Drama",6.0,16672,65000000,74070,122519874,-64925930,57519874
1349,Bridge of Spies,"Oct 16, 2015",2015,142.0,"Drama,History,Thriller",7.6,263004,40000000,72313754,162498338,32313754,122498338
1350,The BFG,"Jul 1, 2016",2016,117.0,"Adventure,Family,Fantasy",6.4,69340,140000000,55483770,199646680,-84516230,59646680
1353,Power Rangers,"Mar 24, 2017",2017,124.0,"Action,Adventure,Sci-Fi",6.0,92013,120000000,85364450,142531552,-34635550,22531552
1356,Gifted,"Apr 7, 2017",2017,101.0,Drama,7.6,82426,7000000,24801212,36964656,17801212,29964656
1357,Kong: Skull Island,"Mar 10, 2017",2017,118.0,"Action,Adventure,Fantasy",6.6,237720,185000000,168052812,561072059,-16947188,376072059
1358,Godzilla: King of the Monsters,"May 31, 2019",2019,132.0,"Action,Adventure,Fantasy",6.7,36479,170000000,85576941,299276941,-84423059,129276941
1359,Lion,"Nov 25, 2016",2016,118.0,"Biography,Drama",8.1,181601,12000000,51739495,149570720,39739495,137570720
1361,The Second Mother,"Aug 28, 2015",2015,112.0,"Comedy,Drama",7.8,10833,1200000,376976,3249041,-823024,2049041
1363,My Big Fat Greek Wedding 2,"Mar 25, 2016",2016,94.0,"Comedy,Romance",6.0,25933,18000000,59689605,92096558,41689605,74096558
1364,The Equalizer 2,"Jul 20, 2018",2018,121.0,"Action,Crime,Thriller",6.7,97963,77000000,102084362,190453132,25084362,113453132
1365,Solo: A Star Wars Story,"May 25, 2018",2018,135.0,"Action,Adventure,Fantasy",7.0,226243,275000000,213767512,393151347,-61232488,118151347
1367,La La Land,"Dec 9, 2016",2016,128.0,"Comedy,Drama,Music",8.0,436070,20000000,151101803,426351163,131101803,406351163
1368,We Are Your Friends,"Aug 28, 2015",2015,96.0,"Drama,Music,Romance",6.2,32327,2000000,3591417,10153415,1591417,8153415
1369,The Nice Guys,"May 20, 2016",2016,116.0,"Action,Comedy,Crime",7.4,240337,50000000,36261763,59596747,-13738237,9596747
1370,Son of Saul,"Dec 18, 2015",2015,107.0,"Drama,War",7.5,39232,1700000,1777043,9696537,77043,7996537
1371,The Predator,"Sep 14, 2018",2018,107.0,"Action,Adventure,Sci-Fi",5.4,94888,88000000,51024708,159487563,-36975292,71487563
1373,War Room,"Aug 28, 2015",2015,120.0,Drama,6.5,11716,3000000,67790117,73975239,64790117,70975239
1375,Dope,"Jun 19, 2015",2015,103.0,"Comedy,Crime,Drama",7.2,76557,7000000,17506470,18190831,10506470,11190831
1376,Krampus,"Dec 4, 2015",2015,98.0,"Comedy,Fantasy,Horror",6.2,55400,15000000,42725475,61788393,27725475,46788393
1377,Dumbo,"Mar 29, 2019",2019,112.0,"Adventure,Family,Fantasy",6.6,25072,170000000,113883318,345004422,-56116682,175004422
1378,The Perfect Guy,"Sep 11, 2015",2015,100.0,"Crime,Drama,Horror",5.6,8998,18000000,57027435,60278166,39027435,42278166
1379,Bajrangi Bhaijaan,"Jul 17, 2015",2015,163.0,"Action,Comedy,Drama",8.0,63747,13000000,8178001,121778347,-4821999,108778347
1380,The Boss Baby,"Mar 31, 2017",2017,97.0,"Adventure,Animation,Comedy",6.3,93730,125000000,175003033,510878762,50003033,385878762
1381,Baby Driver,"Jun 28, 2017",2017,113.0,"Action,Crime,Drama",7.6,363977,34000000,107825862,228104185,73825862,194104185
1382,Teenage Mutant Ninja Turtles: Out of the Shadows,"Jun 3, 2016",2016,112.0,"Action,Adventure,Comedy",6.0,77234,135000000,82051601,245328374,-52948399,110328374
1383,Mustang,"Nov 20, 2015",2015,97.0,Drama,7.6,30899,1400000,845464,5552584,-554536,4152584
1385,Meet the Mormons,"Oct 10, 2014",2014,78.0,Documentary,6.9,1897,2000000,6047363,6049171,4047363,4049171
1386,The Bye Bye Man,"Jan 13, 2017",2017,96.0,"Drama,Fantasy,Horror",4.3,17743,7400000,22395806,31187727,14995806,23787727
1387,Manchester by the Sea,"Nov 18, 2016",2016,137.0,Drama,7.8,214557,8500000,47695371,77733867,39195371,69233867
1388,Swiss Army Man,"Jun 24, 2016",2016,97.0,"Adventure,Comedy,Drama",7.0,91736,3000000,4210454,5837111,1210454,2837111
1390,Maze Runner: The Scorch Trials,"Sep 18, 2015",2015,131.0,"Action,Sci-Fi,Thriller",6.3,201143,61000000,81697192,310566162,20697192,249566162
1391,The Shallows,"Jun 24, 2016",2016,86.0,"Drama,Horror,Thriller",6.3,106927,13000000,55121623,118763442,42121623,105763442
1392,Do You Believe?,"Mar 20, 2015",2015,120.0,Drama,6.1,6462,2300000,12985600,14304931,10685600,12004931
1395,The Darkest Minds,"Aug 3, 2018",2018,104.0,"Action,Adventure,Drama",5.7,21340,34000000,12695691,38361428,-21304309,4361428
1396,Sardaar Ji,"Dec 31, 2015",2015,141.0,"Comedy,Fantasy,Horror",6.5,1182,2700000,0,8200000,-2700000,5500000
1397,The Purge: Election Year,"Jul 1, 2016",2016,108.0,"Action,Horror,Sci-Fi",6.0,80254,10000000,79042440,118514727,69042440,108514727
1399,Forever My Girl,"Jan 19, 2018",2018,108.0,"Drama,Music,Romance",6.7,10316,3500000,16376066,16376066,12876066,12876066
1400,The Lego Batman Movie,"Feb 10, 2017",2017,104.0,"Action,Animation,Comedy",7.3,116433,80000000,175750384,310660018,95750384,230660018
1401,Fantastic Beasts: The Crimes of Grindelwald,"Nov 16, 2018",2018,134.0,"Adventure,Family,Fantasy",6.6,163151,200000000,159555901,652220086,-40444099,452220086
1402,Florence Foster Jenkins,"Aug 12, 2016",2016,111.0,"Biography,Comedy,Drama",6.8,44970,29000000,27383770,56000339,-1616230,27000339
1403,Keanu,"Apr 29, 2016",2016,100.0,"Action,Comedy,Crime",6.3,41560,15000000,20591853,20688141,5591853,5688141
1405,Captain Marvel,"Mar 8, 2019",2019,123.0,"Action,Adventure,Sci-Fi",7.0,296225,175000000,426525952,1123061550,251525952,948061550
1406,Avengers: Infinity War,"Apr 27, 2018",2018,149.0,"Action,Adventure,Sci-Fi",8.5,670926,300000000,678815482,2048134200,378815482,1748134200
1409,Woodlawn,"Oct 16, 2015",2015,123.0,"Drama,Sport",6.5,6070,13000000,14394097,14403703,1394097,1403703
1410,Meet the Blacks,"Apr 1, 2016",2016,94.0,"Comedy,Horror",5.9,34669,900000,9097072,9097072,8197072,8197072
1411,The Birth of a Nation,"Oct 7, 2016",2016,120.0,"Biography,Drama,History",6.4,18442,10000000,15861566,16891011,5861566,6891011
1413,Jason Bourne,"Jul 29, 2016",2016,123.0,"Action,Thriller",6.6,190596,120000000,162192920,416168316,42192920,296168316
1414,Widows,"Nov 16, 2018",2018,129.0,"Crime,Drama,Thriller",7.0,61615,40000000,42402632,73866088,2402632,33866088
1417,Miracles from Heaven,"Mar 16, 2016",2016,109.0,"Biography,Drama,Family",7.1,17734,13000000,61705123,73798736,48705123,60798736
1420,Kubo and the Two Strings,"Aug 19, 2016",2016,101.0,"Action,Adventure,Animation",7.8,105578,55000000,48023088,77548122,-6976912,22548122
1422,Ouija: Origin of Evil,"Oct 21, 2016",2016,99.0,"Drama,Horror,Mystery",6.1,47099,9000000,35144505,81831866,26144505,72831866
1425,Neighbors 2: Sorority Rising,"May 20, 2016",2016,92.0,Comedy,5.7,102793,35000000,55340730,108757621,20340730,73757621
1426,Fifty Shades Darker,"Feb 10, 2017",2017,118.0,"Drama,Romance",4.6,81706,55000000,114434010,381398492,59434010,326398492
1427,Fifty Shades Freed,"Feb 9, 2018",2018,105.0,"Drama,Romance,Thriller",4.5,43893,55000000,100407760,371350619,45407760,316350619
1428,The Death Cure,"Jan 26, 2018",2018,143.0,"Action,Sci-Fi,Thriller",6.2,91286,61000000,58032443,265878536,-2967557,204878536
1429,Why Him?,"Dec 23, 2016",2016,111.0,Comedy,6.2,89628,38000000,60323786,117425156,22323786,79425156
1431,The Prodigy,"Feb 8, 2019",2019,92.0,"Horror,Thriller",5.9,11456,6000000,14856291,19789712,8856291,13789712
1433,Nocturnal Animals,"Nov 18, 2016",2016,116.0,"Drama,Thriller",7.5,205240,22500000,10663357,32398681,-11836643,9898681
1435,Darkest Hour,"Nov 22, 2017",2017,125.0,"Biography,Drama,History",7.4,136546,30000000,56443120,150807172,26443120,120807172
1436,Mile 22,"Aug 17, 2018",2018,94.0,"Action,Adventure,Thriller",6.1,47862,35000000,36108758,66295121,1108758,31295121
1437,Patriots Day,"Dec 21, 2016",2016,133.0,"Action,Crime,Drama",7.4,76204,40000000,31886361,52837989,-8113639,12837989
1439,Christopher Robin,"Aug 3, 2018",2018,104.0,"Adventure,Animation,Comedy",7.3,52737,75000000,99215042,197504758,24215042,122504758
1440,The Star,"Nov 17, 2017",2017,86.0,"Adventure,Animation,Comedy",6.1,5159,20000000,40847995,62758010,20847995,42758010
1441,Can You Ever Forgive Me?,"Oct 19, 2018",2018,106.0,"Biography,Comedy,Crime",7.2,29473,10000000,8803865,11752387,-1196135,1752387
1444,Glass,"Jan 18, 2019",2019,129.0,"Drama,Sci-Fi,Thriller",6.8,133793,20000000,111035005,245303505,91035005,225303505
1449,Storks,"Sep 23, 2016",2016,87.0,"Adventure,Animation,Comedy",6.8,50448,70000000,72679278,183353431,2679278,113353431
1451,The Fate of the Furious,"Apr 14, 2017",2017,136.0,"Action,Crime,Thriller",6.7,179774,250000000,225764765,1234846267,-24235235,984846267
1452,Almost Christmas,"Nov 11, 2016",2016,111.0,"Comedy,Drama",6.1,5212,17000000,42065185,42493506,25065185,25493506
1453,Kingsman: The Golden Circle,"Sep 22, 2017",2017,141.0,"Action,Adventure,Comedy",6.8,230797,104000000,100234838,408803696,-3765162,304803696
1455,Bad Moms,"Jul 29, 2016",2016,100.0,Comedy,6.2,100952,20000000,113257297,180998716,93257297,160998716
1457,All Saints,"Aug 25, 2017",2017,108.0,Drama,6.0,1220,2000000,5802208,5941994,3802208,3941994
1458,Fifty Shades of Black,"Jan 29, 2016",2016,92.0,Comedy,3.5,17189,5000000,11686940,22113075,6686940,17113075
1459,Kevin Hart: What Now?,"Oct 14, 2016",2016,96.0,"Comedy,Documentary",5.9,8134,10000000,23591043,23591043,13591043,13591043
1460,On the Basis of Sex,"Dec 25, 2018",2018,120.0,"Biography,Drama",6.9,12083,20000000,24622687,38073377,4622687,18073377
1461,Loving,"Nov 4, 2016",2016,123.0,"Biography,Drama,Romance",7.0,28079,9000000,7710234,12898064,-1289766,3898064
1462,Collateral Beauty,"Dec 16, 2016",2016,97.0,"Drama,Romance",6.8,78764,36000000,31016021,85309093,-4983979,49309093
1463,It Comes at Night,"Jun 9, 2017",2017,91.0,"Horror,Mystery",6.2,69039,5000000,13985117,19720203,8985117,14720203
1464,Hunt for the Wilderpeople,"Jun 24, 2016",2016,101.0,"Adventure,Comedy,Drama",7.9,87532,2500000,5205471,23845533,2705471,21345533
1465,Bumblebee,"Dec 21, 2018",2018,114.0,"Action,Adventure,Sci-Fi",6.9,94155,102000000,127195589,465195589,25195589,363195589
1467,Book Club,"May 18, 2018",2018,104.0,"Comedy,Drama,Romance",6.1,18728,10000000,68566296,91113683,58566296,81113683
1468,The Wild Life,"Sep 9, 2016",2016,91.0,"Adventure,Animation,Comedy",5.4,5042,13000000,8005586,42446455,-4994414,29446455
1469,Unfriended: Dark Web,"Jul 20, 2018",2018,92.0,"Crime,Horror,Mystery",5.9,13822,1000000,8866745,16434588,7866745,15434588
1470,Pitch Perfect 3,"Dec 22, 2017",2017,93.0,"Comedy,Music",5.8,45127,45000000,104897530,185736412,59897530,140736412
1471,The Meg,"Aug 10, 2018",2018,113.0,"Action,Horror,Sci-Fi",5.7,114042,178000000,145443742,529530715,-32556258,351530715
1472,How to Be a Latin Lover,"Apr 28, 2017",2017,115.0,"Comedy,Drama",5.9,11747,10000000,32149404,62556228,22149404,52556228
1473,Rough Night,"Jun 16, 2017",2017,101.0,"Comedy,Crime,Thriller",5.2,39447,20000000,22105643,46844357,2105643,26844357
1474,The Best of Enemies,"Apr 5, 2019",2019,133.0,"Biography,Drama,History",6.8,1162,10000000,10205616,10205616,205616,205616
1477,Hidden Figures,"Dec 25, 2016",2016,127.0,"Biography,Drama,History",7.8,171131,25000000,169607287,231771716,144607287,206771716
1478,Baahubali 2: The Conclusion,"Apr 28, 2017",2017,167.0,"Action,Drama",8.3,65656,30000000,18985794,263502914,-11014206,233502914
1480,Us,"Mar 22, 2019",2019,116.0,"Horror,Mystery,Thriller",7.1,102511,20000000,175006930,254210310,155006930,234210310
1481,The Perfect Match,"Mar 11, 2016",2016,96.0,"Comedy,Romance",4.9,3052,5000000,9669521,10182050,4669521,5182050
1483,The Emoji Movie,"Jul 28, 2017",2017,86.0,"Adventure,Animation,Comedy",3.2,47294,50000000,86089513,216562312,36089513,166562312
1484,Jurassic World: Fallen Kingdom,"Jun 22, 2018",2018,128.0,"Action,Adventure,Sci-Fi",6.2,219125,170000000,417719760,1305772799,247719760,1135772799
1487,Lady Bird,"Nov 3, 2017",2017,94.0,"Comedy,Drama",7.4,177677,10000000,48958273,78610769,38958273,68610769
1488,Moonlight,"Oct 21, 2016",2016,111.0,Drama,7.4,227964,1500000,27854931,65245512,26354931,63745512
1489,Middle School: The Worst Years of My Life,"Oct 7, 2016",2016,92.0,"Comedy,Family",6.1,6413,8500000,20007149,23311293,11507149,14811293
1490,"Everything, Everything","May 19, 2017",2017,96.0,"Drama,Romance",6.4,26811,10000000,34121140,61603136,24121140,51603136
1491,Dunkirk,"Jul 21, 2017",2017,106.0,"Action,Drama,History",7.9,466580,150000000,190068280,499837368,40068280,349837368
1492,"Three Billboards Outside Ebbing, Missouri","Nov 10, 2017",2017,115.0,"Crime,Drama",8.2,344047,12000000,54513740,160191915,42513740,148191915
1493,Mary Poppins Returns,"Dec 19, 2018",2018,130.0,"Comedy,Family,Fantasy",6.9,52103,130000000,171958438,341528518,41958438,211528518
1494,Get Out,"Feb 24, 2017",2017,104.0,"Horror,Mystery,Thriller",7.7,400474,5000000,176040665,255367951,171040665,250367951
1495,Sicario: Day of the Soldado,"Jun 29, 2018",2018,122.0,"Action,Crime,Drama",7.1,95650,35000000,50065850,75885196,15065850,40885196
1497,Dangal,"Dec 21, 2016",2016,161.0,"Action,Biography,Drama",8.5,123638,9500000,12391761,294654618,2891761,285154618
1499,The Favourite,"Nov 23, 2018",2018,119.0,"Biography,Drama,History",7.6,116011,15000000,34366783,94113929,19366783,79113929
1500,Ant-Man and the Wasp,"Jul 6, 2018",2018,118.0,"Action,Adventure,Comedy",7.1,244024,130000000,216648740,623144660,86648740,493144660
1502,The Secret Life of Pets 2,"Jun 7, 2019",2019,86.0,"Adventure,Animation,Comedy",6.6,3467,80000000,63795655,113351496,-16204345,33351496
1503,Peter Rabbit,"Feb 9, 2018",2018,95.0,"Adventure,Animation,Comedy",6.6,27908,50000000,115234093,347136477,65234093,297136477
1506,Annabelle: Creation,"Aug 11, 2017",2017,109.0,"Horror,Mystery,Thriller",6.5,90402,15000000,102092201,305384865,87092201,290384865
1508,Indivisible,"Oct 26, 2018",2018,119.0,"Drama,War",5.6,812,2700000,3511417,3588305,811417,888305
1509,"Love, Simon","Mar 16, 2018",2018,110.0,"Comedy,Drama,Romance",7.6,81575,10000000,40826341,65520633,30826341,55520633
1511,Columbus,"Aug 4, 2017",2017,104.0,Drama,7.2,10735,700000,1017107,1110511,317107,410511
1513,Hotel Transylvania 3: Summer Vacation,"Jul 13, 2018",2018,97.0,"Adventure,Animation,Comedy",6.3,42299,65000000,167500092,527079962,102500092,462079962
1514,Paterson,"Dec 28, 2016",2016,118.0,"Comedy,Drama,Romance",7.4,55285,5000000,2141423,10727536,-2858577,5727536
1517,Happy Death Day,"Oct 13, 2017",2017,96.0,"Horror,Mystery,Thriller",6.5,87132,5000000,55683845,125010260,50683845,120010260
1518,Never Look Away,"Nov 30, 2018",2018,189.0,"Drama,History,Romance",7.7,4758,1400000,1303747,4331152,-96253,2931152
1519,Wish Upon,"Jul 14, 2017",2017,90.0,"Drama,Fantasy,Horror",5.0,14962,12000000,14301505,23477345,2301505,11477345
1520,Logan Lucky,"Aug 18, 2017",2017,118.0,"Comedy,Crime,Drama",7.0,105966,29000000,27778642,44264271,-1221358,15264271
1521,The Big Sick,"Jun 23, 2017",2017,120.0,"Comedy,Drama,Romance",7.6,104008,5000000,42872467,53972860,37872467,48972860
1522,Deadpool 2,"May 18, 2018",2018,119.0,"Action,Adventure,Comedy",7.8,391735,110000000,324591735,786680557,214591735,676680557
1524,The Nutcracker and the Four Realms,"Nov 2, 2018",2018,99.0,"Adventure,Family,Fantasy",5.5,18734,132900000,54858851,170293899,-78041149,37393899
1526,"I, Tonya","Dec 8, 2017",2017,120.0,"Biography,Comedy,Drama",7.5,141668,11000000,30014534,53797409,19014534,42797409
1527,The Hate U Give,"Oct 5, 2018",2018,133.0,"Crime,Drama",7.3,17583,23000000,29719483,35067665,6719483,12067665
1528,The Shape of Water,"Dec 1, 2017",2017,123.0,"Adventure,Drama,Fantasy",7.3,308112,19500000,63859435,195790794,44359435,176290794
1531,Faces Places,"Oct 6, 2017",2017,94.0,Documentary,7.9,8261,1000000,952432,4015686,-47568,3015686
1533,Night School,"Sep 28, 2018",2018,111.0,Comedy,5.6,23501,29000000,77339130,103008792,48339130,74008792
1534,The Florida Project,"Oct 6, 2017",2017,111.0,Drama,7.6,72193,2000000,5904366,11295324,3904366,9295324
1535,Goosebumps 2: Haunted Halloween,"Oct 12, 2018",2018,90.0,"Adventure,Comedy,Family",5.6,11459,35000000,46697321,93291478,11697321,58291478
1536,Sorry to Bother You,"Jul 6, 2018",2018,111.0,"Comedy,Fantasy,Sci-Fi",7.0,40290,3200000,17493096,18285560,14293096,15085560
1537,Slender Man,"Aug 10, 2018",2018,93.0,"Horror,Mystery,Thriller",3.2,19650,10000000,30564825,51723644,20564825,41723644
1541,Cold Pursuit,"Feb 8, 2019",2019,119.0,"Action,Crime,Drama",6.2,27648,60000000,32138862,62599159,-27861138,2599159
1542,Insidious: The Last Key,"Jan 5, 2018",2018,103.0,"Horror,Mystery,Thriller",5.7,42154,10000000,67745330,167885588,57745330,157885588
1543,The Possession of Hannah Grace,"Nov 30, 2018",2018,86.0,"Horror,Mystery,Thriller",5.2,11629,6000000,14836174,42785387,8836174,36785387
1545,Skyscraper,"Jul 13, 2018",2018,102.0,"Action,Adventure,Thriller",5.8,81193,125000000,68420120,304115534,-56579880,179115534
1547,Let There Be Light,"Oct 27, 2017",2017,100.0,Drama,4.8,2179,3000000,7233471,7241309,4233471,4241309
1548,Let There Be Light,"Oct 27, 2017",2017,80.0,Documentary,6.7,127,3000000,7233471,7241309,4233471,4241309
1550,Diary of a Wimpy Kid: The Long Haul,"May 19, 2017",2017,91.0,"Comedy,Family",4.4,5635,22000000,20738724,35609577,-1261276,13609577
1555,Acrimony,"Mar 30, 2018",2018,120.0,"Drama,Romance,Thriller",5.7,6119,20000000,43549096,46627836,23549096,26627836
1557,The First Purge,"Jul 4, 2018",2018,98.0,"Action,Horror,Sci-Fi",5.1,41741,13000000,69488745,136617305,56488745,123617305
1558,Aladdin,"May 24, 2019",2019,128.0,"Adventure,Comedy,Family",7.4,57549,182000000,246734314,619234314,64734314,437234314
1562,Posledniy bogatyr,"Dec 31, 2017",2017,114.0,"Action,Adventure,Comedy",6.6,1853,8500000,0,30700192,-8500000,22200192
1565,Smallfoot,"Sep 28, 2018",2018,96.0,"Adventure,Animation,Comedy",6.7,23295,80000000,83240103,213691277,3240103,133691277
1567,A Ghost Story,"Jul 7, 2017",2017,92.0,"Drama,Fantasy,Romance",6.8,46280,100000,1594798,2769782,1494798,2669782
1568,Patti Cake$,"Aug 18, 2017",2017,109.0,"Drama,Music",6.7,8581,1000000,800148,1471090,-199852,471090
1569,The Post,"Dec 22, 2017",2017,116.0,"Biography,Drama,History",7.2,108017,50000000,81903458,179748880,31903458,129748880
1570,Adrift,"Jun 1, 2018",2018,96.0,"Action,Adventure,Biography",6.6,34115,35000000,31445011,57897191,-3554989,22897191
1572,Creed II,"Nov 21, 2018",2018,130.0,"Drama,Sport",7.2,72503,50000000,115715889,213591522,65715889,163591522
1574,A Quiet Place,"Apr 6, 2018",2018,90.0,"Drama,Horror,Sci-Fi",7.6,305031,17000000,188024361,334522294,171024361,317522294
1575,A Bad Moms Christmas,"Nov 1, 2017",2017,104.0,"Adventure,Comedy",5.5,33056,28000000,72110659,127710550,44110659,99710550
1576,Wonder Park,"Mar 15, 2019",2019,85.0,"Adventure,Animation,Comedy",5.7,3091,100000000,45216793,115149422,-54783207,15149422
1577,I Can Only Imagine,"Mar 16, 2018",2018,110.0,"Biography,Drama,Family",7.4,11439,7000000,83482352,85604221,76482352,78604221
1578,Five Feet Apart,"Mar 15, 2019",2019,116.0,"Drama,Romance",7.2,10645,7000000,45729221,80504421,38729221,73504421
1582,Upgrade,"Jun 1, 2018",2018,100.0,"Action,Sci-Fi,Thriller",7.6,104978,3000000,11977130,16553285,8977130,13553285
1587,The Intruder,"May 3, 2019",2019,102.0,"Drama,Horror,Mystery",5.5,1912,8000000,35095904,36005871,27095904,28005871
1588,I Feel Pretty,"Apr 20, 2018",2018,110.0,"Comedy,Romance",5.4,39936,32000000,48795601,91553797,16795601,59553797
1590,The 15:17 to Paris,"Feb 9, 2018",2018,94.0,"Biography,Drama,Thriller",5.2,21880,30000000,36276286,56096200,6276286,26096200
1591,Peppermint,"Sep 7, 2018",2018,101.0,"Action,Crime,Drama",6.5,35854,25000000,35418723,51800758,10418723,26800758
1592,Green Book,"Nov 16, 2018",2018,130.0,"Biography,Comedy,Drama",8.3,204972,23000000,85080171,322034439,62080171,299034439
1594,Eighth Grade,"Jul 13, 2018",2018,93.0,"Comedy,Drama",7.5,43256,2000000,13539710,14341016,11539710,12341016
1595,A Simple Favor,"Sep 14, 2018",2018,117.0,"Comedy,Crime,Drama",6.9,83338,20000000,53548586,97628717,33548586,77628717
1596,If Beale Street Could Talk,"Dec 14, 2018",2018,119.0,"Drama,Romance",7.2,25512,12000000,14915773,19859167,2915773,7859167
1597,Breaking In,"May 11, 2018",2018,88.0,"Action,Crime,Drama",5.4,10154,6000000,46840590,51411620,40840590,45411620
1598,Unsane,"Mar 23, 2018",2018,98.0,"Drama,Horror,Mystery",6.4,32049,1500000,7690044,14244931,6190044,12744931
1600,Hearts Beat Loud,"Jun 8, 2018",2018,97.0,"Comedy,Drama,Music",6.9,6543,2000000,2386254,2420962,386254,420962
1602,Uncle Drew,"Jun 29, 2018",2018,103.0,"Comedy,Sport",5.7,9739,18000000,42469946,46527161,24469946,28527161
1603,BlacKkKlansman,"Aug 10, 2018",2018,135.0,"Biography,Crime,Drama",7.5,149005,15000000,49275340,93017335,34275340,78017335
1605,"Paul, Apostle of Christ","Mar 23, 2018",2018,108.0,"Adventure,Biography,Drama",6.7,5662,5000000,17547999,25529498,12547999,20529498
1606,Instant Family,"Nov 16, 2018",2018,118.0,"Comedy,Drama",7.4,46728,48000000,67363237,119736188,19363237,71736188
1611,What Men Want,"Feb 8, 2019",2019,117.0,"Comedy,Fantasy,Romance",4.9,10141,20000000,54611903,69911903,34611903,49911903
1612,SuperFly,"Jun 13, 2018",2018,116.0,"Action,Crime,Thriller",5.0,4753,16000000,20537137,20723581,4537137,4723581
1614,Hereditary,"Jun 8, 2018",2018,127.0,"Drama,Horror,Mystery",7.3,151571,10000000,44069456,70133905,34069456,60133905
1617,Happy Death Day 2U,"Feb 13, 2019",2019,100.0,"Drama,Horror,Mystery",6.3,27462,9000000,28051045,64179495,19051045,55179495
1620,Fahrenheit 11/9,"Sep 21, 2018",2018,128.0,Documentary,6.7,11628,5000000,6352306,6653715,1352306,1653715
1624,Unplanned,"Mar 29, 2019",2019,106.0,"Biography,Drama",6.3,5945,6000000,18107621,18107621,12107621,12107621
